Player;Age;90s;Tkl;TklW;Def 3rd;Mid 3rd;Att 3rd;Tkl;Att;Tkl%;Lost;Blocks;Sh;Pass;Int;Tkl+Int;Clr;Err;Price
Igor Zubeldia;26;28.2;35;18;28;7;0;25;35;71.4;10;23;17;6;21;56;93;0;
Kurt Zouma;29;22.1;9;4;4;5;0;5;8;62.5;3;17;14;3;30;39;120;1;
Tanguy Zoukrou;20;5.7;14;7;8;6;0;10;14;71.4;4;18;11;7;2;16;24;0;
Nadir Zortea;24;7.3;15;8;12;2;1;9;14;64.3;5;10;4;6;4;19;21;0;
Oleksandr Zinchenko;27;23.5;40;18;14;17;9;21;39;53.8;18;20;2;18;22;62;38;2;
David Zima;23;4.5;9;5;5;4;0;3;4;75.0;1;7;2;5;9;18;11;2;
Nathan Zeze;18;0.7;3;2;2;1;0;1;1;100.0;0;0;0;0;0;3;1;0;
Jordan Zemura;24;16.2;39;24;24;14;1;23;43;53.5;20;31;9;22;16;55;32;0;
Aaron Zehnter;19;0.0;0;0;0;0;0;0;1;0.0;1;0;0;0;1;1;0;0;
Marvin Zeegelaar;33;3.9;8;4;6;2;0;3;4;75.0;1;2;0;2;3;11;5;0;
Deyovaisio Zeefuik;25;0.1;1;1;0;1;0;0;0;;0;0;0;0;0;1;0;0;
Akim Zedadka;28;17.8;35;21;21;10;4;18;32;56.3;14;17;3;14;23;58;51;1;
Davide Zappacosta;31;16.4;34;18;17;12;5;15;22;68.2;7;23;2;21;9;43;16;0;
Mattia Zanotti;20;0.3;0;0;0;0;0;0;1;0.0;1;2;0;2;0;0;0;0;
Alessandro Zanoli;23;0.1;1;0;0;1;0;0;0;;0;0;0;0;0;1;1;0;
Alessandro Zanoli;23;17.1;22;14;14;6;2;8;17;47.1;9;19;15;4;12;34;39;0;
Nicola Zalewski;21;24.4;45;26;25;15;5;22;71;31.0;49;27;1;26;31;76;23;0;
Joseba Zaldúa;31;7.1;15;8;10;4;1;7;10;70.0;3;4;2;2;11;26;22;0;
Dan-Axel Zagadou;24;14.1;14;9;10;4;0;5;14;35.7;9;19;16;3;21;35;81;1;
Illia Zabarnyi;21;3.3;4;2;4;0;0;3;7;42.9;4;7;2;5;3;7;14;0;
Mohamed Youssouf;35;27.3;72;44;41;24;7;38;61;62.3;23;32;8;24;65;137;70;0;
Ashley Young;38;22.6;50;27;34;15;1;37;49;75.5;12;25;11;14;21;71;65;0;
Maya Yoshida;35;28.4;34;22;19;13;2;18;29;62.1;11;40;29;11;46;80;132;2;
Leny Yoro;18;8.5;11;5;8;3;0;4;9;44.4;5;6;1;5;18;29;27;1;
Darlin Yongwa;23;8.7;13;11;7;5;1;4;15;26.7;11;13;1;12;5;18;11;0;
Jawad El Yamiq;31;17.9;17;11;10;7;0;6;11;54.5;5;27;19;8;37;54;101;0;
Joe Worrall;26;24.7;53;25;39;12;2;25;35;71.4;10;33;23;10;26;79;111;1;
Christopher Wooh;22;11.2;16;7;8;8;0;9;11;81.8;2;11;5;6;6;22;49;0;
Marius Wolf;28;17.4;25;18;9;12;4;16;29;55.2;13;40;10;30;18;43;22;1;
Maximilian Wöber;25;14.1;25;18;9;15;1;16;24;66.7;8;32;14;18;27;52;67;1;
Przemysław Wiśniewski;25;11.1;13;6;7;6;0;6;18;33.3;12;16;8;8;11;24;66;0;
Frederik Winther;22;1.0;2;2;1;1;0;0;2;0.0;2;1;1;0;0;2;7;0;
Neco Williams;22;20.9;72;47;49;17;6;38;71;53.5;33;33;8;25;33;105;48;0;
Mateusz Wieteska;26;34.6;41;23;28;13;0;19;33;57.6;14;44;28;16;56;97;97;4;
Silvan Widmer;30;18.8;26;17;15;10;1;20;39;51.3;19;22;8;14;31;57;28;0;
Ben White;26;33.9;60;31;23;30;7;42;70;60.0;28;47;11;36;22;82;79;1;
Adam Webster;28;22.1;22;12;10;9;3;11;19;57.9;8;30;19;11;19;41;55;4;
Joel Ward;34;25.1;50;36;30;11;9;30;41;73.2;11;32;16;16;25;75;80;1;
Aaron Wan-Bissaka;26;15.9;40;25;20;17;3;23;25;92.0;2;24;8;16;22;62;41;0;
Sebastian Walukiewicz;23;6.7;9;6;7;2;0;4;6;66.7;2;10;9;1;7;16;30;0;
Kyle Walker-Peters;26;29.4;61;32;34;24;3;22;42;52.4;20;47;8;39;27;88;52;0;
Kyle Walker;33;21.8;13;9;8;5;0;4;24;16.7;20;12;2;10;18;31;22;0;
Stefan de Vrij;31;21.6;28;18;19;9;0;8;14;57.1;6;18;10;8;40;68;80;0;
Mërgim Vojvoda;28;19.1;22;12;15;6;1;12;24;50.0;12;14;2;12;10;32;31;1;
Kevin Vogt;32;19.7;15;10;10;5;0;9;22;40.9;13;18;11;7;26;41;67;0;
Daniel Vivian;24;26.4;57;32;36;16;5;36;45;80.0;9;27;14;13;24;81;90;3;
Mattia Viti;21;7.0;4;2;1;1;2;2;5;40.0;3;9;3;6;8;12;22;0;
Matías Viña;26;0.6;3;1;1;1;1;1;3;33.3;2;5;1;4;2;5;5;0;
Matías Viña;26;5.1;19;11;9;8;2;14;30;46.7;16;13;1;12;4;23;22;0;
Nacho Vidal;28;13.9;27;14;16;6;5;17;32;53.1;15;17;4;13;19;46;33;1;
João Victor;25;9.4;19;11;9;7;3;12;22;54.5;10;11;1;10;15;34;30;0;
Gonzalo Verdú;35;7.8;10;5;8;2;0;4;8;50.0;4;8;6;2;10;20;33;0;
Lorenzo Venuti;28;10.3;18;7;6;11;1;11;18;61.1;7;7;2;5;5;23;17;2;
Micky van de Ven;22;33.0;45;30;26;18;1;28;39;71.8;11;42;24;18;26;71;108;2;
Joël Veltman;31;24.3;62;32;44;14;4;37;57;64.9;20;27;8;19;19;81;51;0;
Miloš Veljković;28;25.2;30;19;17;13;0;18;29;62.1;11;32;16;16;33;63;103;0;
Renato Veiga;20;7.1;9;6;4;3;2;7;9;77.8;2;20;6;14;7;16;29;1;
Lucas Vázquez;32;12.7;34;23;22;10;2;20;28;71.4;8;10;0;10;7;41;13;0;
Johan Vásquez;25;20.1;41;26;34;7;0;18;39;46.2;21;27;20;7;45;86;93;1;
Raphaël Varane;30;21.2;24;9;18;6;0;7;17;41.2;10;24;17;7;11;35;91;0;
Virgil van Dijk;32;31.5;27;14;13;11;3;8;19;42.1;11;24;16;8;31;58;138;2;
Jesús Vallejo;26;0.2;0;0;0;0;0;0;0;;0;0;0;0;0;0;0;0;
Martin Valjent;28;29.5;35;27;22;12;1;19;28;67.9;9;39;21;18;29;64;137;0;
Enrique Valiente;21;4.1;1;1;1;0;0;0;0;;0;4;3;1;5;6;23;0;
Yan Valery;24;27.7;54;39;28;20;6;20;37;54.1;17;35;15;20;34;88;82;0;
Yan Valery;24;0.5;0;0;0;0;0;0;0;;0;1;0;1;0;0;3;0;
Emanuele Valeri;25;30.9;54;27;29;21;4;29;69;42.0;40;17;3;14;22;76;44;1;
Josha Vagnoman;23;16.4;26;15;12;11;3;15;27;55.6;12;20;2;18;8;34;29;1;
Jere Uronen;29;7.5;14;10;6;6;2;6;10;60.0;4;5;2;3;8;22;13;0;
Jere Uronen;29;3.3;8;5;4;4;0;7;12;58.3;5;6;2;4;7;15;5;0;
Filip Uremović;26;19.2;38;23;29;8;1;14;22;63.6;8;18;13;5;36;74;88;2;
Dayot Upamecano;25;26.1;65;37;43;22;0;28;45;62.2;17;26;6;20;27;92;71;4;
Samuel Umtiti;30;23.5;52;34;25;25;2;18;26;69.2;8;26;14;12;26;78;79;0;
Iyenoma Udogie;21;30.0;71;45;42;24;5;34;59;57.6;25;34;6;28;36;107;25;0;
Tuta;24;30.2;53;35;27;19;7;33;57;57.9;24;47;14;33;49;102;134;2;
Alessandro Tuia;33;5.7;10;6;6;4;0;3;9;33.3;6;3;1;2;15;25;29;0;
Kostas Tsimikas;27;8.6;14;9;10;2;2;10;16;62.5;6;8;1;7;12;26;15;0;
Adrien Truffert;22;21.7;62;32;36;17;9;31;46;67.4;15;32;8;24;22;84;55;0;
William Troost-Ekong;30;4.9;11;3;7;4;0;6;7;85.7;1;7;4;3;6;17;10;0;
Kieran Trippier;33;37.1;71;49;36;27;8;46;90;51.1;44;45;15;30;43;114;84;2;
Christopher Trimmel;36;20.1;31;16;16;12;3;20;31;64.5;11;14;1;13;25;56;48;0;
Hamari Traoré;31;28.1;48;32;26;15;7;28;52;53.8;24;33;7;26;38;86;64;0;
Charles Traore;31;5.4;8;5;5;2;1;5;7;71.4;2;9;2;7;10;18;12;0;
Souleymane Touré;20;17.6;29;13;19;9;1;16;20;80.0;4;32;12;20;26;55;56;1;
Souleymane Touré;20;0.8;2;1;1;1;0;1;2;50.0;1;1;0;1;0;2;5;0;
Almamy Touré;27;4.4;13;7;7;5;1;5;9;55.6;4;9;2;7;10;23;8;0;
Pau Torres;26;33.9;43;25;25;13;5;23;36;63.9;13;36;27;9;13;56;146;3;
David Torres;20;4.3;1;1;0;1;0;1;1;100.0;0;4;2;2;3;4;8;0;
Lorenzo Tonelli;33;0.2;0;0;0;0;0;0;1;0.0;1;0;0;0;0;0;0;0;
Fikayo Tomori;26;30.7;70;34;44;25;1;22;34;64.7;12;46;25;21;29;99;88;1;
James Tomkins;34;3.8;4;2;2;1;1;1;3;33.3;2;3;2;1;5;9;19;0;
Takehiro Tomiyasu;25;7.4;27;18;12;10;5;13;18;72.2;5;7;0;7;14;41;15;1;
Rafael Tolói;33;30.9;69;44;37;32;0;35;64;54.7;29;42;18;24;57;126;88;1;
Jeremy Toljan;29;29.7;36;23;17;14;5;22;33;66.7;11;31;14;17;18;54;60;1;
Harry Toffolo;28;10.4;17;8;10;4;3;10;14;71.4;4;16;8;8;10;27;33;0;
Jean-Clair Todibo;24;31.9;76;48;54;19;3;41;56;73.2;15;41;19;22;41;117;110;2;
Kieran Tierney;26;8.8;20;11;9;9;2;12;16;75.0;4;8;2;6;11;31;25;0;
Luke Thomas;22;11.9;23;19;15;5;3;15;32;46.9;17;20;4;16;27;50;35;0;
Malick Thiaw;22;3.0;3;1;2;1;0;1;2;50.0;1;4;3;1;9;12;24;1;
Malick Thiaw;22;15.1;31;26;22;9;0;11;20;55.0;9;11;5;6;12;43;65;1;
Arthur Theate;23;34.7;29;19;17;8;4;17;30;56.7;13;26;14;12;30;59;114;3;
Kenny Tete;28;28.5;83;46;41;29;13;38;50;76.0;12;48;17;31;52;135;81;1;
Aleksa Terzić;24;10.4;16;9;9;4;3;11;21;52.4;10;13;4;9;5;21;16;0;
Alex Telles;31;15.9;21;13;15;6;0;13;25;52.0;12;17;5;12;20;41;38;0;
Enzo Tchato;21;12.2;26;17;14;11;1;13;22;59.1;9;17;2;15;7;33;33;0;
James Tarkowski;31;38.0;51;26;36;13;2;20;38;52.6;18;99;78;21;51;102;201;3;
Matt Targett;28;6.8;13;10;8;3;2;9;24;37.5;15;8;3;5;9;22;16;0;
Edmond Tapsoba;24;31.9;51;30;35;12;4;30;42;71.4;12;40;17;23;36;87;109;1;
Japhet Tanganga;24;1.6;3;2;3;0;0;1;5;20.0;4;1;0;1;2;5;8;0;
Thibault Tamas;22;0.1;0;0;0;0;0;0;0;;0;0;0;0;1;1;0;0;
Montassar Talbi;25;38.0;53;25;40;13;0;22;35;62.9;13;55;34;21;40;93;190;3;
Jonathan Tah;27;27.6;25;12;21;4;0;12;18;66.7;6;30;18;12;40;65;118;0;
Nicolás Tagliafico;31;33.2;91;53;36;41;14;50;78;64.1;28;45;11;34;57;148;47;0;
Issiaga Sylla;29;15.2;28;15;14;9;5;15;34;44.1;19;15;5;10;38;66;38;0;
Issiaga Sylla;29;14.5;28;16;19;8;1;15;31;48.4;16;19;3;16;32;60;35;0;
Niklas Süle;28;23.5;25;19;18;3;4;14;23;60.9;9;28;19;9;17;42;53;0;
Gabriel Suazo;26;14.0;38;22;20;15;3;29;63;46.0;34;21;5;16;22;60;24;1;
Pascal Struijk;24;24.4;84;57;43;31;10;49;75;65.3;26;32;12;20;32;116;70;1;
Petar Stojanović;28;17.0;42;22;28;10;4;26;43;60.5;17;17;5;12;11;53;55;0;
Jack Stephens;29;13.0;15;11;10;4;1;6;10;60.0;4;23;16;7;16;31;53;0;
Jack Stephens;29;0.5;2;2;2;0;0;1;1;100.0;0;1;1;0;1;3;2;0;
Pascal Stenzel;27;3.7;12;8;8;4;0;5;9;55.6;4;9;2;7;5;17;6;0;
Niklas Stark;28;23.1;56;36;29;24;3;27;42;64.3;15;24;13;11;37;93;110;0;
Josip Stanišić;23;6.4;19;11;14;2;3;12;17;70.6;5;9;1;8;7;26;11;3;
Jack Stacey;27;3.3;5;4;3;1;1;2;5;40.0;3;3;1;2;5;10;15;0;
Leonardo Spinazzola;30;18.4;15;8;7;6;2;8;23;34.8;15;13;3;10;9;24;25;0;
Djed Spence;23;6.4;14;6;8;2;4;11;18;61.1;7;10;3;7;4;18;15;0;
Çağlar Söyüncü;27;5.9;14;9;10;4;0;7;10;70.0;3;9;8;1;7;21;30;0;
Harry Souttar;25;11.0;15;9;10;5;0;7;18;38.9;11;16;12;4;12;27;45;0;
Adama Soumaoro;31;20.7;25;17;11;12;2;5;7;71.4;2;18;13;5;15;40;75;1;
Joaquin Sosa;21;7.6;6;2;5;1;0;4;18;22.2;14;5;3;2;6;12;31;0;
Borna Sosa;25;21.7;27;21;18;8;1;21;32;65.6;11;20;5;15;19;46;37;0;
Brandon Soppy;21;7.1;8;5;4;4;0;3;9;33.3;6;10;0;10;3;11;7;0;
Brandon Soppy;21;1.0;1;1;0;1;0;0;0;;0;4;0;4;1;2;1;0;
Nikola Soldo;22;6.6;15;9;8;7;0;7;11;63.6;4;7;6;1;7;22;28;0;
Alex Sola;24;3.9;18;9;14;3;1;7;10;70.0;3;7;2;5;7;25;10;0;
Eduard Sobol;28;9.7;19;10;10;6;3;9;13;69.2;4;10;1;9;8;27;19;0;
Danilo Soares;32;19.6;72;46;42;23;7;43;72;59.7;29;29;6;23;30;102;56;1;
Cédric Soares;32;2.2;8;5;4;3;1;3;3;100.0;0;3;1;2;1;9;5;0;
Cédric Soares;32;0.3;0;0;0;0;0;0;1;0.0;1;1;0;1;0;0;1;0;
Hrvoje Smolčić;23;5.2;8;7;6;2;0;5;10;50.0;5;11;4;7;6;14;38;0;
Adam Smith;32;32.7;49;29;27;19;3;29;60;48.3;31;30;13;17;25;74;81;1;
Chris Smalling;34;31.2;26;15;16;10;0;13;21;61.9;8;51;36;15;43;69;123;0;
Milan Škriniar;28;19.7;29;18;14;11;4;18;32;56.3;14;18;13;5;13;42;46;3;
Robert Skov;27;15.0;22;11;14;7;1;10;26;38.5;16;22;8;14;8;30;20;2;
Leo Skiri Østigård;24;4.7;4;1;3;1;0;1;1;100.0;0;3;3;0;6;10;18;1;
Hugo Siquet;21;0.2;2;2;2;0;0;2;2;100.0;0;1;0;1;0;2;0;0;
Wilfried Singo;23;22.8;27;17;14;10;3;12;19;63.2;7;15;2;13;12;39;33;1;
Mohamed Simakan;23;16.2;21;14;12;5;4;14;21;66.7;7;21;4;17;16;37;55;0;
Thiago Silva;39;26.1;41;27;24;17;0;21;31;67.7;10;38;29;9;34;75;111;2;
Caio Henrique Oliveira Silva;26;32.2;74;51;42;28;4;44;76;57.9;32;28;8;20;26;100;68;1;
Luke Shaw;28;28.4;55;36;31;22;2;32;45;71.1;13;51;17;34;36;91;55;2;
Ryan Sessegnon;23;9.0;16;11;9;7;0;6;12;50.0;6;8;1;7;6;22;17;1;
Leonardo Sernicola;26;25.7;45;33;25;13;7;29;43;67.4;14;23;6;17;38;83;55;0;
Marcos Senesi;26;27.7;50;35;28;22;0;23;43;53.5;20;38;20;18;43;93;146;2;
Marvin Senaya;22;0.1;0;0;0;0;0;0;1;0.0;1;1;0;1;0;0;1;0;
Nélson Semedo;30;29.2;71;42;48;19;4;33;64;51.6;31;42;15;27;29;100;83;2;
Alidu Seidu;23;27.3;52;31;35;14;3;31;51;60.8;20;28;14;14;52;104;50;2;
Jacopo Segre;26;0.2;0;0;0;0;0;0;0;;0;0;0;0;0;0;0;0;
Perr Schuurs;24;25.9;51;25;29;17;5;14;26;53.8;12;28;16;12;28;79;102;0;
Benno Schmitz;29;26.9;64;42;31;28;5;42;82;51.2;40;34;4;30;26;90;57;0;
Kenneth Schmidt;21;2.8;6;3;4;2;0;5;6;83.3;1;4;2;2;0;6;2;0;
Jonathan Schmid;33;0.5;1;1;1;0;0;0;0;;0;1;0;1;1;2;1;1;
Nico Schlotterbeck;24;25.0;59;34;34;24;1;37;53;69.8;16;38;21;17;32;91;71;1;
Keven Schlotterbeck;26;8.2;17;9;12;5;0;9;11;81.8;2;11;5;6;14;31;49;0;
Keven Schlotterbeck;26;0.2;0;0;0;0;0;0;0;;0;1;1;0;2;2;2;0;
Fabian Schär;32;35.6;47;22;31;13;3;24;39;61.5;15;34;19;15;52;99;139;0;
Giorgio Scalvini;20;25.9;54;29;30;18;6;29;55;52.7;26;36;13;23;56;110;57;2;
Joe Scally;21;24.5;31;20;25;5;1;24;31;77.4;7;17;6;11;8;39;61;0;
Stefan Savić;32;21.6;39;26;29;7;3;26;39;66.7;13;17;8;9;33;72;67;2;
Malang Sarr;24;8.0;6;3;5;1;0;1;5;20.0;4;11;7;4;15;21;29;2;
Alex Sandro;32;19.9;35;20;16;16;3;15;22;68.2;7;27;10;17;15;50;64;1;
Manuel Sánchez;23;23.6;51;35;35;9;7;33;63;52.4;30;33;5;28;14;65;51;0;
Javi Sánchez;26;26.6;43;26;27;15;1;17;26;65.4;9;32;22;10;46;89;116;0;
Davinson Sánchez;27;9.5;24;11;17;6;1;14;20;70.0;6;16;10;6;12;36;41;0;
Junior Sambia;27;7.7;12;5;7;4;1;6;10;60.0;4;9;3;6;8;20;16;1;
Yoann Salmier;31;29.4;51;29;34;12;5;21;35;60.0;14;34;19;15;39;90;124;0;
Mohammed Salisu;24;21.9;51;29;33;16;2;24;34;70.6;10;56;25;31;31;82;122;1;
William Saliba;22;26.8;34;20;23;9;2;15;18;83.3;3;13;10;3;19;53;85;4;
Mamadou Sakho;33;8.5;9;5;4;5;0;3;5;60.0;2;17;12;5;8;17;35;1;
Théo Sainte-Luce;25;5.9;13;11;8;5;0;7;14;50.0;7;7;2;5;10;23;11;0;
Falaye Sacko;28;28.7;46;25;25;15;6;32;51;62.7;19;43;14;29;33;79;75;1;
Halid Šabanović;24;7.1;8;6;7;1;0;6;8;75.0;2;8;2;6;8;16;12;0;
Youssouf Sabaly;30;18.7;45;23;29;14;2;22;33;66.7;11;35;8;27;19;64;52;1;
Julian Ryerson;26;15.7;27;15;17;7;3;19;37;51.4;18;13;2;11;8;35;28;0;
Julian Ryerson;26;11.5;28;17;17;10;1;15;25;60.0;10;15;3;12;12;40;19;0;
Franco Russo;29;1.6;2;1;2;0;0;0;1;0.0;1;5;0;5;3;5;5;0;
Víctor Ruiz;34;6.2;5;3;3;2;0;3;3;100.0;0;10;7;3;6;11;34;0;
Mário Rui;32;19.4;34;22;17;13;4;20;41;48.8;21;17;4;13;15;49;24;1;
Daniele Rugani;29;6.3;7;0;6;1;0;4;4;100.0;0;7;5;2;7;14;32;0;
Antonio Rüdiger;30;26.8;18;16;12;5;1;14;23;60.9;9;23;13;10;19;37;74;0;
Ruan;24;19.0;38;26;25;12;1;19;29;65.5;10;29;17;12;24;62;80;3;
Amir Rrahmani;29;27.2;33;18;20;13;0;17;26;65.4;9;36;20;16;14;47;79;1;
Jérôme Roussillon;30;10.6;16;9;6;8;2;8;12;66.7;4;7;2;5;4;20;22;0;
Anthony Rouault;22;36.8;66;37;54;10;2;30;58;51.7;28;52;26;26;56;122;126;4;
Tom Rothe;19;0.3;1;1;0;1;0;1;1;100.0;0;0;0;0;1;2;2;0;
Cristian Romero;25;26.3;68;36;42;24;2;29;46;63.0;17;40;18;22;44;112;102;3;
Simone Romagnoli;33;1.9;6;5;3;3;0;2;2;100.0;0;4;1;3;1;7;11;0;
Alessio Romagnoli;28;32.5;33;15;19;14;0;11;22;50.0;11;33;26;7;38;71;108;0;
Filippo Romagna;26;0.5;0;0;0;0;0;0;0;;0;1;1;0;0;0;2;0;
Rogério;25;33.3;37;21;22;8;7;17;35;48.6;18;32;9;23;37;74;70;0;
Agustín Rogel;26;15.8;18;9;13;5;0;11;17;64.7;6;15;8;7;11;29;74;1;
Mads Roerslev;24;12.3;22;12;19;3;0;16;33;48.5;17;14;5;9;9;31;38;0;
Ricardo Rodríguez;31;29.7;54;33;30;17;7;28;42;66.7;14;30;15;15;38;92;61;0;
Joe Rodon;26;15.7;11;7;9;2;0;4;10;40.0;6;16;12;4;9;20;54;1;
Enzo Roco;31;18.4;33;13;23;10;0;15;24;62.5;9;22;15;7;17;50;63;1;
Antonee Robinson;26;34.3;62;38;43;15;4;44;65;67.7;21;49;13;36;53;115;83;3;
Andrew Robertson;29;28.7;38;21;12;16;10;21;41;51.2;20;32;5;27;18;56;50;3;
Diego Rico;30;18.3;35;21;17;11;7;12;27;44.4;15;18;5;13;20;55;51;1;
Chris Richards;23;5.0;9;6;8;1;0;5;7;71.4;2;10;1;9;8;17;31;0;
Alexsandro Ribeiro;24;17.9;32;18;24;7;1;19;28;67.9;9;11;2;9;25;57;59;1;
Alejandro Revuelta Montero;23;0.0;0;0;0;0;0;0;0;;0;0;0;0;0;0;1;0;
Panagiotis Retsos;25;1.4;5;4;2;2;1;3;3;100.0;0;4;1;3;2;7;3;0;
Karim Rekik;29;13.1;11;5;8;3;0;4;5;80.0;1;12;5;7;10;21;24;0;
Sergio Reguilón;27;3.4;7;5;5;2;0;5;7;71.4;2;3;0;3;2;9;4;0;
Nathan Redmond;29;0.0;0;0;0;0;0;0;0;;0;0;0;0;0;0;0;0;
Arkadiusz Reca;28;24.1;44;28;22;12;10;19;32;59.4;13;21;5;16;24;68;54;0;
Tim Ream;36;32.2;30;16;15;12;3;13;26;50.0;13;45;24;21;41;71;116;2;
Andrea Ranocchia;35;0.5;3;1;1;2;0;3;4;75.0;1;5;5;0;0;3;7;0;
Luca Ranieri;24;5.6;9;4;6;3;0;6;9;66.7;3;5;3;2;11;20;15;1;
Sergio Ramos;37;30.0;34;26;14;18;2;23;44;52.3;21;29;13;16;34;68;93;3;
Adil Rami;38;17.7;19;14;13;5;1;17;32;53.1;15;23;16;7;25;44;75;3;
Simon Ramet;20;0.0;0;0;0;0;0;0;0;;0;0;0;0;0;0;0;0;
Antonio Raillo;32;30.7;34;21;23;11;0;10;15;66.7;5;38;29;9;31;65;158;1;
Rubén Quintanilla;21;0.0;0;0;0;0;0;0;0;;0;1;0;1;0;0;0;0;
Eduardo Quaresma;21;1.0;5;3;3;2;0;1;3;33.3;2;3;2;1;0;5;3;0;
Giacomo Quagliata;23;7.8;10;8;7;1;2;5;11;45.5;6;7;2;5;11;21;8;0;
Tymoteusz Puchacz;24;0.6;1;0;1;0;0;0;0;;0;0;0;0;0;1;1;0;
Alejandro Pozo Pozo;24;20.9;37;19;17;17;3;27;53;50.9;26;30;5;25;26;63;45;1;
Stefan Posch;26;0.2;0;0;0;0;0;0;0;;0;0;0;0;0;0;0;0;
Stefan Posch;26;28.1;81;43;41;29;11;44;75;58.7;31;44;15;29;35;116;69;0;
Jackson Porozo;23;18.0;32;20;24;7;1;13;31;41.9;18;24;17;7;33;65;75;0;
Marin Pongračić;26;8.8;16;14;8;7;1;5;7;71.4;2;4;3;1;16;32;31;0;
Marvin Plattenhardt;31;26.7;43;33;24;15;4;29;47;61.7;18;25;11;14;15;58;82;0;
Lorenzo Pirola;21;21.6;33;29;18;14;1;19;27;70.4;8;50;35;15;30;63;85;1;
Gerard Piqué;36;4.3;5;4;1;4;0;4;4;100.0;0;2;1;1;2;7;19;0;
Ethan Pinnock;30;30.0;52;28;33;12;7;18;24;75.0;6;41;31;10;35;87;215;2;
Ronaël Pierre-Gabriel;25;7.3;25;18;11;12;2;15;17;88.2;2;16;3;13;9;34;22;0;
Ronaël Pierre-Gabriel;25;2.6;17;9;12;4;1;5;11;45.5;6;5;2;3;9;26;11;0;
Amos Pieper;25;21.7;46;28;25;19;2;24;40;60.0;16;23;11;12;30;76;94;1;
Nathaniel Phillips;26;0.7;2;1;0;2;0;2;2;100.0;0;0;0;0;2;4;1;0;
Giuseppe Pezzella;26;10.2;21;9;16;2;3;9;16;56.3;7;11;3;8;8;29;31;1;
Germán Pezzella;32;27.9;41;28;32;9;0;26;38;68.4;12;32;15;17;50;91;129;1;
Lucas Perrin;25;19.6;44;27;28;14;2;25;49;51.0;24;13;5;8;36;80;53;0;
Romain Perraud;26;20.4;54;33;23;23;8;28;52;53.8;24;24;6;18;20;74;42;0;
Nehuén Pérez;23;31.3;77;40;54;20;3;39;55;70.9;16;53;23;30;35;112;106;1;
Luis Pérez;28;13.5;44;24;26;12;6;27;38;71.1;11;13;4;9;16;60;29;0;
Brayann Pereira;20;2.0;6;5;5;1;0;1;5;20.0;4;2;2;0;2;8;8;1;
Timothee Pembele;21;2.9;5;5;3;1;1;2;4;50.0;2;2;0;2;4;9;2;0;
Théo Pellenard;29;1.1;1;0;1;0;0;1;1;100.0;0;3;1;2;2;3;2;0;
Luca Pellegrini;24;6.2;13;8;10;3;0;8;8;100.0;0;8;2;6;7;20;11;1;
Luca Pellegrini;24;2.0;1;0;0;1;0;1;4;25.0;3;3;0;3;7;8;4;0;
Peter Pekarík;37;2.3;4;3;4;0;0;4;6;66.7;2;6;2;4;4;8;7;0;
Alfonso Pedraza;27;18.1;35;26;20;10;5;19;29;65.5;10;19;1;18;18;53;31;0;
Kristian Pedersen;29;3.1;5;4;4;1;0;0;2;0.0;2;3;0;3;6;11;17;0;
Benjamin Pavard;27;27.0;70;41;36;26;8;36;48;75.0;12;35;16;19;44;114;83;0;
Gabriel Paulista;33;16.7;17;9;13;4;0;13;19;68.4;6;22;14;8;32;49;79;2;
Patric;30;15.7;17;11;12;3;2;11;16;68.8;5;17;12;5;11;28;53;1;
Felix Passlack;25;0.7;4;3;0;4;0;1;1;100.0;0;1;1;0;0;4;1;0;
Raúl Parra;24;3.4;4;2;4;0;0;4;9;44.4;5;5;3;2;1;5;9;0;
Fabiano Parisi;23;31.4;65;35;37;21;7;30;72;41.7;42;51;16;35;41;106;91;0;
Aitor Paredes;23;9.5;7;6;4;2;1;6;11;54.5;5;11;7;4;14;21;26;0;
Antonios Papadopoulos;24;0.1;0;0;0;0;0;0;0;;0;0;0;0;1;1;0;0;
Emerson Palmieri;29;14.7;26;14;9;15;2;12;24;50.0;12;17;4;13;15;41;36;0;
Erik Palmer-Brown;26;35.5;42;27;31;10;1;18;33;54.5;15;56;29;27;26;68;166;1;
Nicolas Pallois;36;24.6;69;44;51;16;2;42;70;60.0;28;35;18;17;30;99;131;2;
Helibelton Palacios;30;21.3;38;20;21;15;2;19;26;73.1;7;26;12;14;20;58;55;0;
Jon Pacheco;22;13.3;16;10;10;6;0;6;10;60.0;4;9;6;3;12;28;37;1;
Cenk Özkacar;23;15.2;27;20;17;10;0;14;19;73.7;5;14;2;12;12;39;47;4;
Reece Oxford;25;1.0;1;1;1;0;0;0;0;;0;4;3;1;1;2;5;0;
Thomas Ouwejan;27;10.0;20;8;13;5;2;6;10;60.0;4;17;4;13;13;33;27;0;
Paulo Otávio;29;22.7;72;46;46;17;9;44;66;66.7;22;42;6;36;30;102;70;1;
Ivan Ordets;31;27.2;31;19;21;9;1;16;28;57.1;12;34;17;17;57;88;139;0;
Willi Orban;31;32.8;51;30;33;18;0;26;43;60.5;17;42;24;18;39;90;129;1;
Warmed Omari;23;15.1;20;11;14;6;0;14;28;50.0;14;13;7;6;17;37;43;1;
Mathías Olivera;26;18.3;39;23;16;16;7;22;43;51.2;21;28;2;26;22;61;26;0;
Lucas Oliveira Rosa;23;10.3;39;18;23;10;6;12;20;60.0;8;12;2;10;15;54;24;0;
Brian Oliván;29;26.7;47;27;30;12;5;17;26;65.4;9;26;6;20;22;69;67;0;
Lucas Olaza;29;16.6;24;14;12;10;2;17;26;65.4;9;20;8;12;14;38;34;0;
Caleb Okoli;22;10.7;21;17;14;6;1;10;25;40.0;15;10;5;5;30;51;44;3;
Marios Oikonomou;31;2.4;3;2;3;0;0;1;3;33.3;2;5;4;1;4;7;13;0;
Florent Ogier;34;18.9;33;16;20;12;1;22;39;56.4;17;22;13;9;18;51;64;1;
Angelo Ogbonna;35;13.7;11;4;7;4;0;5;10;50.0;5;11;7;4;17;28;74;1;
Odeluga Offiah;21;0.3;1;1;1;0;0;0;2;0.0;2;0;0;0;0;1;1;0;
Tim Oermann;20;2.2;2;1;2;0;0;1;1;100.0;0;3;2;1;1;3;8;1;
Álvaro Odriozola;28;0.4;0;0;0;0;0;0;0;;0;0;0;0;0;0;0;0;
Gerzino Nyamsi;26;17.5;28;20;14;12;2;10;12;83.3;2;19;11;8;10;38;63;1;
Bram Nuytinck;33;16.6;54;38;33;21;0;23;34;67.6;11;36;21;15;23;77;84;0;
Bram Nuytinck;33;4.3;7;4;3;4;0;4;8;50.0;4;6;6;0;5;12;22;0;
Unai Núñez;26;35.0;47;35;29;15;3;18;34;52.9;16;27;17;10;72;119;135;1;
Rasmus Nissen;26;21.8;62;35;35;21;6;42;76;55.3;34;32;14;18;35;97;61;0;
Dimitris Nikolaou;25;32.9;45;32;31;10;4;25;37;67.6;12;41;26;15;27;72;82;0;
Rasmus Nicolaisen;26;33.3;48;21;34;14;0;29;46;63.0;17;58;45;13;50;98;152;0;
Tanguy Nianzou;21;15.2;20;15;10;9;1;8;11;72.7;3;8;5;3;16;36;44;3;
Moussa Niakhate;27;12.9;18;9;15;3;0;11;22;50.0;11;18;8;10;19;37;60;0;
Luca Netz;20;7.8;25;13;19;3;3;19;32;59.4;13;5;1;4;6;31;27;0;
Matija Nastasić;30;10.1;10;8;7;1;2;3;6;50.0;3;11;4;7;18;28;43;1;
Nacho;33;18.2;24;16;17;5;2;12;29;41.4;17;11;6;5;18;42;37;0;
Stanley N'Soki;24;14.3;22;13;14;7;1;12;22;54.5;10;22;5;17;24;46;34;0;
Obite N'Dicka;24;29.9;25;18;10;11;4;18;32;56.3;14;47;19;28;31;56;150;0;
Vitaliy Mykolenko;24;29.5;58;34;36;19;3;28;51;54.9;23;50;16;34;46;104;99;0;
Nicola Murru;29;8.7;24;14;15;8;1;7;13;53.8;6;17;7;10;10;34;21;0;
Jeison Murillo;31;11.7;22;11;16;6;0;17;26;65.4;9;22;14;8;8;30;39;0;
Aihen Muñoz;26;19.5;38;23;17;17;4;22;47;46.8;25;26;5;21;9;47;38;0;
Abdul Mumin;25;10.2;11;9;5;6;0;3;7;42.9;4;13;5;8;9;20;36;2;
Nordi Mukiele;26;12.6;31;23;16;6;9;19;29;65.5;10;22;9;13;14;45;16;0;
Cristhian Mosquera;19;1.6;4;2;3;1;0;4;5;80.0;1;1;0;1;1;5;5;0;
Diego Moreno;22;7.1;4;4;2;2;0;3;8;37.5;5;7;4;3;5;9;21;0;
Álex Moreno;30;15.0;29;22;19;10;0;18;36;50.0;18;17;4;13;17;46;39;0;
Álex Moreno;30;14.8;23;14;15;5;3;13;36;36.1;23;18;3;15;7;30;37;2;
Alberto Moreno;31;14.4;23;12;10;10;3;11;24;45.8;13;12;1;11;23;46;26;0;
Martín Montoya;32;5.0;13;8;9;4;0;10;12;83.3;2;6;1;5;9;22;14;1;
Gonzalo Montiel;26;16.9;26;15;12;14;0;15;29;51.7;14;25;7;18;19;45;38;0;
César Montes;26;17.7;17;9;10;7;0;10;18;55.6;8;19;12;7;14;31;101;0;
Salvatore Molina;31;2.5;6;5;2;4;0;4;5;80.0;1;4;2;2;1;7;2;0;
Nahuel Molina;25;31.9;69;43;38;18;13;39;91;42.9;52;38;7;31;18;87;63;1;
Clinton Mola;22;0.2;3;1;2;1;0;1;1;100.0;0;1;1;0;1;4;2;0;
Johan Mojica;31;7.1;13;9;9;3;1;5;9;55.6;4;8;3;5;4;17;14;1;
Stefan Mitrović;33;18.7;14;6;12;2;0;7;11;63.6;4;12;10;2;17;31;90;2;
Tyrick Mitchell;24;32.1;71;49;43;23;5;30;53;56.6;23;48;11;37;42;113;78;0;
Filippo Missori;19;2.0;4;3;3;0;1;3;6;50.0;3;0;0;0;3;7;5;0;
Juan Miranda;23;16.4;23;16;16;6;1;14;29;48.3;15;20;7;13;20;43;63;0;
Óscar Mingueza;24;14.3;37;21;27;9;1;25;32;78.1;7;10;4;6;12;49;25;0;
Tyrone Mings;30;35.0;15;7;10;5;0;9;20;45.0;11;40;21;19;54;69;163;2;
Yerry Mina;29;6.6;15;8;9;6;0;9;11;81.8;2;7;4;3;6;21;28;0;
Kim Min-jae;27;33.9;55;30;32;22;1;25;29;86.2;4;36;26;10;41;96;123;1;
Éder Militão;25;30.0;46;32;25;18;3;26;33;78.8;7;67;39;28;42;88;104;2;
Nikola Milenković;26;23.7;40;25;20;17;3;18;27;66.7;9;27;14;13;22;62;72;0;
Thomas Meunier;32;6.5;16;7;8;5;3;10;17;58.8;7;7;2;5;9;25;16;0;
Yıldırım Mert Çetin;26;0.2;1;0;1;0;0;0;0;;0;0;0;0;1;2;1;0;
Quentin Merlin;21;19.9;31;19;19;8;4;18;38;47.4;20;27;4;23;24;55;30;0;
Jorge Meré;26;6.7;11;7;9;2;0;5;8;62.5;3;9;6;3;6;17;32;0;
Chris Mepham;26;24.4;45;22;37;8;0;19;30;63.3;11;40;27;13;30;75;152;0;
Gideon Mensah;25;25.1;80;44;43;32;5;44;77;57.1;33;33;10;23;38;118;41;0;
Ferland Mendy;28;15.0;21;12;14;6;1;12;20;60.0;8;7;2;5;14;35;16;0;
Arial Mendy;29;2.5;4;2;3;0;1;2;2;100.0;0;2;0;2;4;8;4;0;
Antoine Mendy;19;5.8;22;13;16;5;1;9;15;60.0;6;6;1;5;2;24;16;0;
Pedro Mendes;33;0.1;0;0;0;0;0;0;0;;0;0;0;0;0;0;0;1;
Nuno Mendes;21;17.2;45;30;29;12;4;30;41;73.2;11;19;3;16;17;62;18;0;
Houboulang Mendes;25;9.8;19;11;16;3;0;11;27;40.7;16;12;2;10;7;26;23;1;
Birger Meling;29;13.4;24;15;9;12;3;12;25;48.0;13;18;2;16;23;47;26;0;
Bamo Meïté;22;16.7;18;8;13;4;1;7;16;43.8;9;33;23;10;16;34;70;0;
Ben Mee;34;36.3;45;24;28;13;4;20;37;54.1;17;54;42;12;48;93;122;1;
Fernando Medrano;23;0.1;2;1;2;0;0;1;1;100.0;0;0;0;0;1;3;1;0;
Facundo Medina;24;30.9;31;20;16;15;0;13;35;37.1;22;25;9;16;26;57;62;1;
Scott McKenna;27;17.5;12;7;7;3;2;6;10;60.0;4;20;14;6;12;24;85;1;
Chancel Mbemba;29;31.7;43;26;24;17;2;22;31;71.0;9;25;12;13;42;85;89;0;
Mamadou Mbaye;25;8.4;10;7;7;3;0;6;8;75.0;2;10;8;2;7;17;50;1;
Pasquale Mazzocchi;28;21.7;32;18;21;5;6;17;37;45.9;20;10;2;8;10;42;37;2;
Noussair Mazraoui;26;11.9;29;21;9;9;11;15;24;62.5;9;13;2;11;10;39;25;0;
Fernand Mayembo;27;7.9;8;5;6;2;0;4;9;44.4;5;2;0;2;11;19;36;0;
Philipp Max;30;7.7;12;9;4;7;1;5;16;31.3;11;10;2;8;3;15;11;0;
Christian Mawissa;18;1.1;2;0;1;1;0;1;3;33.3;2;0;0;0;3;5;1;0;
Konstantinos Mavropanos;26;25.4;50;27;32;15;3;28;38;73.7;10;39;18;21;63;113;99;0;
Chrislain Matsima;21;5.0;11;6;7;2;2;4;7;57.1;3;5;5;0;9;20;16;0;
Henning Matriciani;23;20.7;43;23;28;12;3;26;60;43.3;34;28;11;17;23;66;57;1;
Joël Matip;32;12.1;14;8;12;2;0;11;23;47.8;12;8;3;5;21;35;45;3;
Adam Masina;29;8.8;10;7;7;3;0;6;15;40.0;9;11;4;7;10;20;28;1;
Adam Marušić;31;30.7;41;30;23;14;4;25;39;64.1;14;20;6;14;38;79;63;1;
Roger Martínez;19;0.1;0;0;0;0;0;0;0;;0;0;0;0;0;0;0;0;
Lucas Martínez Quarta;27;24.1;80;48;44;32;4;42;61;68.9;19;41;19;22;48;128;78;1;
Lisandro Martínez;25;23.5;54;28;33;18;3;30;43;69.8;13;51;27;24;33;87;103;0;
Iñigo Martínez;32;14.9;18;8;11;7;0;6;9;66.7;3;17;11;6;18;36;55;0;
Arnau Martinez;20;30.4;69;45;41;19;9;38;85;44.7;47;44;10;34;25;94;54;2;
Aarón Martín;26;20.5;42;27;25;11;6;21;40;52.5;19;22;1;21;15;57;31;0;
Luca Marrone;33;1.5;0;0;0;0;0;0;2;0.0;2;2;2;0;0;0;4;1;
Marquinhos;29;30.2;33;25;18;12;3;18;26;69.2;8;43;27;16;23;56;83;2;
Marlon;28;17.7;35;21;20;14;1;15;29;51.7;14;13;4;9;18;53;50;0;
Guillermo Maripán;29;24.0;46;26;26;20;0;17;33;51.5;16;39;27;12;38;84;87;0;
José María Giménez;28;26.9;43;25;28;14;1;24;35;68.6;11;37;17;20;24;67;138;1;
Pablo Marí;30;27.6;37;19;29;7;1;17;26;65.4;9;22;14;8;31;68;111;3;
Óscar de Marcos;34;31.3;67;33;34;22;11;40;76;52.6;36;42;6;36;29;96;59;0;
Gian Marco Ferrari;31;24.7;23;16;11;10;2;10;17;58.8;7;29;20;9;23;46;81;4;
Riccardo Marchizza;25;3.1;2;2;1;1;0;2;4;50.0;2;2;0;2;2;4;8;0;
Marcão;27;4.2;2;2;1;1;0;1;1;100.0;0;3;3;0;6;8;14;0;
Javier Manquillo;29;0.4;3;2;2;1;0;2;2;100.0;0;1;0;1;1;4;1;0;
Aïssa Mandi;32;16.2;18;10;14;3;1;6;12;50.0;6;19;14;5;21;39;58;0;
Reinildo Mandava;29;20.6;66;43;46;19;1;38;49;77.6;11;27;12;15;30;96;59;0;
Gianluca Mancini;27;31.8;37;19;27;9;1;18;34;52.9;16;38;17;21;46;83;67;0;
Hugo Mallo;32;24.0;53;29;34;14;5;28;42;66.7;14;28;7;21;24;77;73;0;
Tyrell Malacia;24;15.5;46;33;33;12;1;14;25;56.0;11;13;3;10;25;71;49;0;
Harry Maguire;30;8.5;8;6;6;1;1;4;5;80.0;1;18;11;7;13;21;41;0;
Giangiacomo Magnani;28;17.0;33;22;20;11;2;19;25;76.0;6;20;15;5;21;54;76;0;
Lisandro Magallán;30;10.0;19;11;11;5;3;10;12;83.3;2;14;5;9;13;32;30;1;
Pablo Maffeo;26;33.1;75;46;54;16;5;45;78;57.7;33;38;11;27;26;101;76;0;
Charalambos Lykogiannis;30;12.3;16;8;5;6;5;5;13;38.5;8;9;4;5;15;31;30;0;
Lyanco;26;13.1;24;16;15;9;0;12;18;66.7;6;30;25;5;20;44;65;2;
Sebastiano Luperto;27;34.8;33;18;24;8;1;9;20;45.0;11;54;42;12;43;76;163;1;
Castello Lukeba;21;33.2;39;23;27;8;4;21;31;67.7;10;42;24;18;75;114;105;1;
José Luis Palomino;33;8.4;23;14;16;7;0;11;19;57.9;8;11;4;7;28;51;20;0;
José Luis Gayà;28;30.1;80;46;61;16;3;43;74;58.1;31;28;9;19;23;103;48;0;
Jhon Lucumí;25;32.2;53;37;39;13;1;24;43;55.8;19;43;26;17;35;88;100;1;
Dejan Lovren;34;16.2;25;19;20;5;0;20;29;69.0;9;20;10;10;26;51;70;1;
Matteo Lovato;23;9.0;17;14;14;3;0;10;25;40.0;15;8;5;3;13;30;33;2;
Jordan Lotomba;25;27.3;65;38;33;24;8;31;48;64.6;17;38;11;27;32;97;53;0;
David López;34;18.4;31;18;17;13;1;19;27;70.4;8;29;19;10;14;45;64;1;
Renan Lodi;25;24.6;52;39;38;8;6;33;66;50.0;33;25;6;19;33;85;74;0;
Banzouzi Locko;21;3.0;4;3;2;1;1;2;3;66.7;1;4;0;4;2;6;13;0;
Banzouzi Locko;21;11.8;31;16;21;4;6;15;27;55.6;12;17;4;13;20;51;21;0;
Luka Lochoshvili;25;20.4;45;19;30;11;4;22;31;71.0;9;31;10;21;22;67;89;0;
Diego Llorente;30;6.4;10;5;6;4;0;5;12;41.7;7;4;2;2;11;21;20;0;
Diego Llorente;30;7.2;13;10;8;5;0;4;8;50.0;4;6;2;4;15;28;24;2;
Pol Lirola;26;7.0;13;6;9;3;1;8;13;61.5;5;3;2;1;7;20;16;0;
Victor Lindelöf;29;15.2;22;17;10;9;3;9;17;52.9;8;18;9;9;21;43;63;1;
Matthijs de Ligt;24;26.7;32;23;15;16;1;15;24;62.5;9;31;20;11;23;55;85;0;
Philipp Lienhart;27;27.8;29;18;19;10;0;13;27;48.1;14;29;15;14;35;64;97;0;
Christopher Lenz;29;14.3;29;21;17;7;5;16;37;43.2;21;16;3;13;21;50;34;0;
Clément Lenglet;28;22.4;38;23;18;15;5;16;34;47.1;18;26;11;15;18;56;68;2;
Dexter Lembikisa;20;0.3;0;0;0;0;0;0;0;;0;0;0;0;0;0;0;0;
Iñigo Lekue;30;14.7;24;17;20;4;0;12;19;63.2;7;16;2;14;13;37;31;1;
Florian Lejeune;32;28.5;28;17;19;8;1;17;25;68.0;8;24;16;8;15;43;123;0;
Maxim Leitsch;25;7.4;9;7;6;3;0;4;5;80.0;1;7;4;3;18;27;26;1;
Diogo Leite;24;25.0;35;20;21;14;0;21;34;61.8;13;23;14;9;26;61;99;1;
Robin Le Normand;27;31.1;36;23;25;9;2;14;27;51.9;13;22;14;8;33;69;93;0;
Maxime Le Marchand;34;22.4;39;24;23;14;2;19;31;61.3;12;22;14;8;37;76;74;0;
Vincent Le Goff;34;37.0;75;32;56;16;3;45;62;72.6;17;29;9;20;41;116;105;1;
Julien Le Cardinal;26;1.8;6;4;5;0;1;4;6;66.7;2;3;0;3;2;8;5;0;
Manuel Lazzari;30;20.9;33;21;13;14;6;21;36;58.3;15;20;6;14;18;51;36;1;
Valentino Lazaro;27;15.3;10;5;6;0;4;6;14;42.9;8;16;3;13;3;13;29;0;
Jamaal Lascelles;30;2.4;1;0;1;0;0;1;1;100.0;0;3;2;1;0;1;17;0;
Juan Larios;19;1.7;7;6;6;1;0;5;5;100.0;0;2;0;2;3;10;4;0;
Julien Laporte;30;18.4;22;16;18;3;1;16;22;72.7;6;33;27;6;18;40;108;2;
Aymeric Laporte;29;11.0;11;8;6;4;1;7;11;63.6;4;10;4;6;3;14;30;1;
Tariq Lamptey;23;5.0;11;6;6;4;1;5;7;71.4;2;7;3;4;7;18;2;0;
Vassilis Lambropoulos;33;7.0;10;8;7;3;0;6;9;66.7;3;5;3;2;13;23;41;0;
Kenny Lala;32;15.7;36;19;19;15;2;22;38;57.9;16;15;5;10;21;57;28;0;
Stefan Lainer;31;9.1;16;8;10;5;1;10;23;43.5;13;8;1;7;14;30;34;1;
Maxence Lacroix;23;18.1;22;13;15;7;0;8;16;50.0;8;22;11;11;26;48;85;0;
Layvin Kurzawa;31;1.5;3;2;1;1;1;3;3;100.0;0;1;1;0;2;5;4;0;
Marash Kumbulla;23;2.9;4;4;2;2;0;2;3;66.7;1;2;1;1;4;8;6;0;
Sael Kumbedi;18;14.7;47;27;27;13;7;20;38;52.6;18;23;7;16;10;57;16;0;
Lukas Kübler;31;18.2;37;25;24;9;4;18;30;60.0;12;25;11;14;29;66;50;0;
Emil Krafth;29;0.0;0;0;0;0;0;0;0;;0;0;0;0;0;0;0;0;
Boubakar Kouyaté;26;14.0;31;18;18;11;2;19;35;54.3;16;24;14;10;34;65;73;1;
Jules Koundé;25;27.0;37;23;18;13;6;21;31;67.7;10;24;9;15;19;56;61;3;
Kalidou Koulibaly;32;20.0;45;31;34;8;3;26;40;65.0;14;30;13;17;29;74;77;0;
Odilon Kossonou;22;16.9;21;14;12;7;2;8;16;50.0;8;26;11;15;24;45;58;1;
Ezri Konsa;26;36.9;42;20;25;15;2;18;26;69.2;8;41;23;18;26;68;120;3;
Youssouf Koné;28;10.2;28;19;24;4;0;18;25;72.0;7;9;2;7;12;40;32;1;
Ibrahima Konaté;24;17.2;38;26;25;13;0;16;27;59.3;11;12;5;7;26;64;61;4;
Cheick Konaté;19;6.4;19;12;10;7;2;13;22;59.1;9;7;1;6;13;32;8;1;
Timothée Kolodziejczak;32;0.3;0;0;0;0;0;0;1;0.0;1;0;0;0;1;1;1;0;
Sead Kolašinac;30;24.6;52;36;24;22;6;24;37;64.9;13;19;2;17;43;95;35;1;
Rudy Kohon;19;0.7;4;3;4;0;0;2;2;100.0;0;1;0;1;1;5;2;0;
Robin Koch;27;35.3;53;30;32;16;5;24;56;42.9;32;44;21;23;43;96;152;1;
Robin Knoche;31;31.9;45;29;29;12;4;24;47;51.1;23;35;18;17;38;83;140;0;
Ansgar Knauff;21;14.3;36;25;22;11;3;15;34;44.1;19;19;1;18;15;51;26;0;
Lukas Klostermann;27;10.1;16;8;7;9;0;8;15;53.3;7;6;3;3;13;29;31;0;
Pascal Klemens;18;1.0;0;0;0;0;0;0;1;0.0;1;1;0;1;1;1;3;0;
Simon Kjær;34;11.2;15;8;9;6;0;7;11;63.6;4;14;11;3;9;24;35;1;
Jakub Kiwior;23;16.0;22;17;15;7;0;6;24;25.0;18;26;18;8;24;46;71;1;
Jakub Kiwior;23;4.7;7;5;6;1;0;5;8;62.5;3;5;3;2;6;13;10;0;
Presnel Kimpembe;28;8.1;17;8;9;6;2;9;13;69.2;4;12;7;5;13;30;9;1;
Max Kilman;26;36.7;36;20;26;9;1;16;30;53.3;14;70;42;28;19;55;164;1;
Luca Kilian;24;12.5;22;16;14;7;1;12;21;57.1;9;16;8;8;11;33;48;0;
Anthony Khelifa;18;0.1;0;0;0;0;0;0;0;;0;0;0;0;0;0;0;0;
Jonjoe Kenny;26;24.9;46;34;27;16;3;24;42;57.1;18;38;9;29;46;92;74;0;
Marc-Oliver Kempf;28;30.1;44;27;29;14;1;16;22;72.7;6;42;32;10;51;95;143;0;
Lloyd Kelly;25;22.7;33;18;23;9;1;13;19;68.4;6;26;15;11;26;59;101;1;
Check Keita;20;7.6;12;9;9;3;0;4;9;44.4;5;6;5;1;5;17;24;1;
Thilo Kehrer;27;24.8;43;24;25;14;4;21;44;47.7;23;16;6;10;34;77;76;1;
Kévin Keben Biakolo;19;4.0;3;2;2;0;1;0;4;0.0;4;1;0;1;5;8;9;0;
Michael Keane;30;10.9;7;4;5;2;0;5;8;62.5;3;12;7;5;14;21;55;1;
Denso Kasius;21;3.8;12;6;7;4;1;8;10;80.0;2;6;3;3;3;15;6;0;
Rick Karsdorp;28;7.9;21;13;11;7;3;13;22;59.1;9;0;0;0;7;28;15;1;
Marcin Kamiński;31;7.0;6;4;4;0;2;2;4;50.0;2;8;7;1;9;15;28;0;
Waren Kamanzi;23;7.4;16;9;9;5;2;13;19;68.4;6;8;2;6;8;24;9;0;
Justin-Noël Kalumba;19;6.1;9;5;5;2;2;5;16;31.3;11;4;1;3;4;13;5;0;
Pierre Kalulu;23;28.3;57;39;33;21;3;28;42;66.7;14;41;17;24;41;98;56;1;
Gedeon Kalulu;26;27.1;64;34;43;14;7;30;48;62.5;18;32;3;29;28;92;79;2;
Kaiky;19;6.5;5;5;5;0;0;3;7;42.9;4;18;10;8;11;16;28;0;
Pavel Kadeřábek;31;18.5;26;20;10;9;7;15;23;65.2;8;12;2;10;14;40;37;1;
Issa Kaboré;22;11.4;33;19;10;18;5;21;32;65.6;11;11;1;10;12;45;21;1;
Ozan Kabak;23;26.5;51;34;27;21;3;17;30;56.7;13;35;23;12;45;96;83;0;
Mathias Jørgensen;33;12.3;17;8;9;8;0;9;21;42.9;12;19;12;7;16;33;39;1;
James Justin;25;13.9;20;18;7;12;1;9;14;64.3;5;24;6;18;15;35;47;0;
Josip Juranović;28;10.4;9;7;5;2;2;7;18;38.9;11;9;3;6;6;15;22;1;
Christopher Jullien;30;29.9;46;28;29;14;3;28;51;54.9;23;35;18;17;43;89;114;1;
Jubal;30;35.7;41;26;29;11;1;19;38;50.0;19;57;34;23;53;94;193;0;
Juanpe;32;15.8;19;11;10;9;0;11;17;64.7;6;12;9;3;10;29;60;1;
Paul Joly;23;9.6;33;21;21;10;2;19;35;54.3;16;13;2;11;24;57;29;2;
Ben Johnson;23;9.6;20;14;12;4;4;12;18;66.7;6;12;4;8;9;29;28;1;
Juan Jesus;32;10.4;16;11;9;6;1;9;12;75.0;3;18;11;7;10;26;29;0;
Moritz Jenz;24;10.5;14;11;8;5;1;5;8;62.5;3;16;10;6;8;22;53;1;
Julian Jeanvier;31;19.6;32;17;24;8;0;13;22;59.1;9;24;17;7;27;59;96;1;
Javi;25;12.4;21;12;12;7;2;13;21;61.9;8;10;5;5;7;28;38;0;
Pontus Jansson;32;8.0;5;3;4;1;0;3;5;60.0;2;13;9;4;9;14;38;0;
Saidy Janko;28;12.6;23;15;13;8;2;12;20;60.0;8;24;10;14;11;34;33;1;
Paul Jaeckel;25;13.3;24;18;11;11;2;17;35;48.6;18;11;5;6;19;43;44;1;
Armando Izzo;31;27.4;73;50;44;27;2;29;45;64.4;16;29;17;12;50;123;87;1;
Diego Iturralde;20;0.5;1;0;1;0;0;0;2;0.0;2;0;0;0;0;1;1;0;
Hiroki Ito;24;28.5;40;29;24;14;2;18;35;51.4;17;38;17;21;40;80;94;0;
Ko Itakura;26;22.0;29;17;18;7;4;16;30;53.3;14;41;25;16;27;56;95;0;
Ardian Ismajli;27;23.3;40;32;25;15;0;18;24;75.0;6;47;31;16;27;67;120;0;
Ismaily;33;19.8;41;18;16;16;9;17;32;53.1;15;25;5;20;21;62;39;0;
Igor;25;22.9;43;29;21;18;4;20;27;74.1;7;33;14;19;25;68;56;2;
Roger Ibanez;25;31.1;67;33;38;26;3;32;48;66.7;16;30;11;19;66;133;95;2;
Elseid Hysaj;29;22.2;39;23;24;11;4;23;41;56.1;18;31;7;24;20;59;42;0;
Mats Hummels;35;22.4;62;34;38;22;2;32;55;58.2;23;30;16;14;33;95;100;1;
Timo Hübers;27;28.4;43;28;35;8;0;24;52;46.2;28;27;13;14;58;101;153;0;
Petko Hristov;24;4.1;6;4;2;4;0;5;8;62.5;3;4;2;2;4;10;12;0;
Cédric Hountondji;29;34.4;50;36;31;17;2;19;29;65.5;10;44;22;22;59;109;132;1;
Emil Holm;23;15.5;26;15;13;8;5;16;31;51.6;15;21;6;15;9;35;41;0;
Mason Holgate;27;5.6;11;7;8;3;0;3;11;27.3;8;7;3;4;7;18;28;0;
Rob Holding;28;6.3;8;5;4;4;0;3;6;50.0;3;6;5;1;3;11;27;1;
Piero Hincapié;21;27.3;51;34;28;20;3;25;38;65.8;13;41;20;21;31;82;83;1;
Isak Hien;24;29.0;73;36;54;19;0;38;61;62.3;23;40;17;23;31;104;92;1;
Aaron Hickey;21;21.3;38;26;27;11;0;18;32;56.3;14;18;7;11;17;55;32;1;
Jorge Herrando;22;0.3;0;0;0;0;0;0;0;;0;1;0;1;0;0;3;0;
Theo Hernández;26;30.8;43;24;27;15;1;22;38;57.9;16;34;7;27;21;64;35;1;
Mario Hernández;24;1.1;3;2;2;1;0;3;7;42.9;4;2;0;2;2;5;0;0;
Luis Hernández;34;35.0;33;21;25;7;1;22;36;61.1;14;31;24;7;31;64;145;0;
Lucas Hernández;27;5.3;6;4;3;3;0;5;6;83.3;1;2;1;1;5;11;7;0;
Aridane Hernández;34;19.9;21;15;17;4;0;12;25;48.0;13;34;21;13;28;49;96;1;
Mario Hermoso;28;23.4;22;15;14;6;2;9;30;30.0;21;19;9;10;19;41;85;1;
Christophe Hérelle;31;11.8;10;4;7;2;1;4;13;30.8;9;16;11;5;20;30;48;0;
Rico Henry;26;36.0;57;31;20;28;9;22;41;53.7;19;29;8;21;30;87;84;1;
Jack Hendry;28;2.4;0;0;0;0;0;0;1;0.0;1;2;1;1;1;1;7;0;
Dominique Heintz;30;8.8;13;9;5;7;1;6;17;35.3;11;11;7;4;12;25;34;0;
Jonas Hector;33;31.4;112;66;59;43;10;66;113;58.4;47;61;9;52;39;151;74;1;
Jan Paul van Hecke;23;3.3;8;6;3;4;1;5;5;100.0;0;8;5;3;6;14;9;0;
Hans Hateboer;29;15.5;21;13;11;8;2;11;27;40.7;16;23;4;19;12;33;25;0;
Makoto Hasebe;39;14.5;18;12;16;2;0;7;22;31.8;15;22;9;13;17;35;45;0;
Andreas Hanche-Olsen;26;16.6;35;23;24;7;4;22;39;56.4;17;16;8;8;33;68;77;2;
Mathis Hamdi;20;0.8;0;0;0;0;0;0;1;0.0;1;0;0;0;1;1;1;0;
Marcel Halstenberg;32;17.3;40;21;20;15;5;23;41;56.1;18;22;1;21;21;61;29;0;
Lewis Hall;19;7.3;23;12;19;4;0;15;22;68.2;7;8;0;8;11;34;11;1;
Dennis Hadzikadunic;25;6.8;9;6;4;5;0;4;4;100.0;0;5;4;1;3;12;27;0;
Jaouen Hadjam;20;8.9;27;21;13;9;5;16;25;64.0;9;10;3;7;12;39;12;0;
Alexander Hack;30;12.6;30;18;21;9;0;19;33;57.6;14;18;5;13;24;54;45;1;
Norbert Gyömbér;31;19.3;32;23;25;6;1;16;24;66.7;8;33;22;11;35;67;92;0;
Joško Gvardiol;21;24.1;23;17;15;8;0;9;22;40.9;13;34;17;17;34;57;76;1;
Miguel Gutiérrez;22;26.6;41;23;23;13;5;23;37;62.2;14;23;5;18;18;59;42;1;
Malo Gusto;20;17.7;42;26;23;11;8;21;43;48.8;22;22;5;17;28;70;23;1;
Koray Günter;29;8.6;10;8;6;4;0;6;9;66.7;3;10;5;5;11;21;46;0;
Koray Günter;29;11.1;10;6;1;8;1;4;7;57.1;3;24;15;9;30;40;46;0;
Robert Gumny;25;22.4;34;24;13;15;6;11;27;40.7;16;21;7;14;26;60;62;1;
Manuel Gulde;32;7.1;14;8;10;4;0;2;4;50.0;2;5;1;4;19;33;25;0;
Frederic Guilbert;29;16.2;47;29;18;23;6;25;43;58.1;18;24;3;21;43;90;33;1;
Axel Guessand;19;0.9;2;1;2;0;0;1;2;50.0;1;1;0;1;2;4;3;0;
Marc Guéhi;23;37.0;52;27;39;11;2;26;42;61.9;16;45;24;21;45;97;134;3;
Leo Greiml;22;4.0;10;5;4;5;1;5;12;41.7;7;7;3;4;3;13;16;0;
Andrew Gravillon;25;11.5;16;8;9;6;1;8;13;61.5;5;18;9;9;21;37;36;0;
Andrew Gravillon;25;3.5;3;3;0;3;0;0;0;;0;4;2;2;9;12;16;0;
Jonathan Gradit;31;31.4;62;40;30;25;7;31;53;58.5;22;40;26;14;38;100;83;0;
Jeffrey Gouweleeuw;32;31.1;42;27;19;17;6;24;49;49.0;25;41;23;18;50;92;141;2;
Robin Gosens;29;13.2;34;18;15;10;9;15;25;60.0;10;16;2;14;23;57;15;0;
Andoni Gorosabel;27;19.0;41;25;23;9;9;26;43;60.5;17;21;2;19;17;58;23;0;
Oumar Gonzalez;25;28.6;51;28;34;13;4;23;37;62.2;14;32;11;21;52;103;82;0;
Giovanni González;29;10.3;16;8;11;2;3;9;22;40.9;13;8;2;6;7;23;22;0;
Édgar González;26;19.7;28;19;18;7;3;14;27;51.9;13;12;9;3;21;49;120;0;
Diego González;28;10.6;12;7;9;3;0;7;11;63.6;4;14;12;2;7;19;50;1;
Sergi Gómez;31;26.0;29;16;20;9;0;18;22;81.8;4;33;19;14;27;56;125;1;
Joe Gomez;26;16.3;28;21;15;11;2;11;19;57.9;8;17;11;6;24;52;51;2;
Toti Gomes;24;10.9;15;9;11;4;0;9;13;69.2;4;16;8;8;11;26;51;0;
Ben Godfrey;25;8.9;20;11;13;5;2;11;29;37.9;18;12;6;6;8;28;33;1;
Matthias Ginter;29;34.0;43;20;29;12;2;26;40;65.0;14;40;24;16;35;78;153;3;
Mario Gila;23;1.0;3;1;3;0;0;0;1;0.0;1;0;0;0;3;6;3;0;
Óscar Gil;26;28.4;63;37;38;16;9;32;61;52.5;29;51;18;33;31;94;55;1;
Samuel Gigot;30;20.9;46;24;22;21;3;12;15;80.0;3;24;7;17;45;91;85;1;
Niko Gießelmann;32;14.5;21;11;9;9;3;13;31;41.9;18;17;5;12;9;30;28;0;
Faouzi Ghoulam;32;5.3;3;3;1;1;1;3;5;60.0;2;4;2;2;4;7;12;1;
Paolo Ghiglione;26;7.9;16;11;10;3;3;10;23;43.5;13;9;4;5;4;20;12;0;
Valentin Gendrey;23;34.4;88;57;54;25;9;40;71;56.3;31;45;4;41;37;125;89;0;
Dario Gebuhr;20;0.2;0;0;0;0;0;0;1;0.0;1;0;0;0;0;0;0;0;
Federico Gatti;25;16.1;15;11;9;4;2;9;15;60.0;6;20;14;6;21;36;54;2;
Felix Garreta;19;1.0;1;0;0;1;0;0;0;;0;1;1;0;1;2;4;0;
Unai García;31;19.0;23;13;13;8;2;12;17;70.6;5;23;14;9;19;42;60;2;
Fran Garcia;24;37.9;84;54;53;23;8;55;96;57.3;41;49;8;41;44;128;66;0;
David García;29;29.8;34;20;22;12;0;19;22;86.4;3;28;13;15;45;79;151;0;
Carlos García;23;0.3;0;0;0;0;0;0;0;;0;0;0;0;0;0;2;0;
Cristian Gamboa;34;16.4;42;24;27;14;1;21;31;67.7;10;20;7;13;16;58;34;1;
Antonino Gallo;23;27.6;56;36;35;12;9;38;57;66.7;19;37;6;31;13;69;71;0;
Javi Galán;29;35.1;104;72;60;40;4;48;98;49.0;50;54;5;49;41;145;63;1;
Matteo Gabbia;24;6.8;17;10;12;5;0;6;8;75.0;2;8;3;5;5;22;29;0;
Marvin Friedrich;28;13.9;17;11;13;3;1;10;13;76.9;3;14;6;8;11;28;52;0;
Marco Friedl;25;28.8;62;46;40;22;0;41;68;60.3;27;46;17;29;58;120;127;1;
Iván Fresneda;19;19.4;48;34;31;13;4;29;47;61.7;18;32;8;24;15;63;60;0;
Ryan Fredericks;31;5.9;3;2;2;0;1;1;4;25.0;3;7;2;5;1;4;27;0;
Juan Foyth;25;21.8;73;48;49;22;2;41;57;71.9;16;32;11;21;20;93;68;0;
Dimitri Foulquier;30;19.3;31;19;17;8;6;20;28;71.4;8;19;3;16;14;45;40;0;
Timothy Fosu-Mensah;25;2.1;7;5;3;3;1;4;4;100.0;0;2;0;2;0;7;1;0;
Steven Fortes;31;0.1;0;0;0;0;0;0;0;;0;0;0;0;0;0;0;0;
José Fonte;40;28.8;23;17;18;4;1;10;21;47.6;11;27;14;13;25;48;112;2;
Thomas Foket;29;22.0;35;22;18;11;6;17;46;37.0;29;21;7;14;33;68;29;2;
Wesley Fofana;23;13.1;30;18;19;7;4;13;26;50.0;13;17;10;7;20;50;33;2;
Wesley Fofana;23;2.0;4;2;1;2;1;1;3;33.3;2;1;1;0;9;13;5;0;
Alessandro Florenzi;32;2.3;6;4;3;2;1;4;7;57.1;3;1;0;1;4;10;2;0;
Junior Firpo;27;15.2;47;25;27;15;5;24;46;52.2;22;23;7;16;24;71;40;0;
Karol Fila;25;0.5;0;0;0;0;0;0;0;;0;0;0;0;1;1;1;0;
Salvador Ferrer;25;1.5;4;2;2;2;0;1;3;33.3;2;3;1;2;1;5;4;0;
Alex Ferrari;29;11.2;40;23;32;7;1;28;42;66.7;14;19;4;15;25;65;45;1;
Alex Ferrari;29;9.6;9;5;7;2;0;4;8;50.0;4;21;10;11;19;28;25;0;
Joaquín Fernández;27;24.0;35;28;20;11;4;19;30;63.3;11;31;22;9;27;62;98;1;
Federico Fernández;34;1.0;1;1;1;0;0;1;1;100.0;0;0;0;0;2;3;12;0;
Edimilson Fernandes;27;27.1;35;25;26;5;4;18;34;52.9;16;37;16;21;54;89;87;2;
Kiko Femenía;32;12.6;18;9;14;3;1;13;18;72.2;5;15;6;9;20;38;22;0;
Ohis Felix Uduokhai;26;16.1;30;20;14;13;3;15;29;51.7;14;27;14;13;29;59;61;1;
Luiz Felipe;26;19.6;34;23;23;11;0;18;34;52.9;16;43;24;19;28;62;106;0;
Felipe;34;2.2;3;2;1;2;0;2;4;50.0;2;2;2;0;0;3;7;0;
Felipe;34;15.8;42;23;29;13;0;24;41;58.5;17;34;13;21;36;78;90;0;
Zouhair Feddal;34;4.2;4;2;1;3;0;3;4;75.0;1;9;9;0;5;9;27;0;
Federico Fazio;36;11.9;15;12;8;7;0;4;11;36.4;7;9;4;5;28;43;61;0;
Davide Faraoni;32;16.5;34;24;19;13;2;16;41;39.0;25;30;11;19;15;49;37;0;
Mamadou Fall;21;0.3;0;0;0;0;0;0;0;;0;1;0;1;0;0;1;0;
Fallou Fall;19;0.4;0;0;0;0;0;0;1;0.0;1;3;3;0;0;0;4;0;
Wout Faes;25;3.0;1;1;1;0;0;1;2;50.0;1;6;3;3;7;8;19;0;
Wout Faes;25;31.0;56;33;28;26;2;28;44;63.6;16;53;37;16;41;97;113;2;
Noah Fadiga;24;14.5;30;21;18;9;3;14;26;53.8;12;17;7;10;26;56;18;0;
Kimberly Ezekwem;22;0.1;0;0;0;0;0;0;0;;0;1;0;1;0;0;0;0;
Jonny Evans;35;11.7;13;5;12;1;0;7;11;63.6;4;15;11;4;18;31;51;0;
Pervis Estupiñán;25;29.7;61;31;36;19;6;35;60;58.3;25;30;8;22;37;98;37;1;
Maxime Estève;21;18.3;24;13;17;5;2;12;17;70.6;5;28;17;11;34;58;90;0;
Bernardo Espinosa;34;13.6;6;2;2;4;0;3;9;33.3;6;17;10;7;12;18;70;2;
Alfonso Espino;31;34.7;87;56;55;20;12;48;96;50.0;48;52;11;41;48;135;99;3;
Sergio Escudero;34;16.0;33;19;21;8;4;15;35;42.9;20;26;6;20;26;59;46;0;
Martin Erlic;25;25.9;27;16;18;8;1;10;23;43.5;13;36;23;13;31;58;120;1;
Emerson;24;19.3;54;33;38;12;4;27;40;67.5;13;17;3;14;18;72;75;0;
Rodrigo Ely;30;35.1;30;21;26;4;0;18;25;72.0;7;46;33;13;31;61;203;1;
Nico Elvedi;27;31.4;46;24;32;12;2;27;41;65.9;14;31;16;15;35;81;149;3;
Aritz Elustondo;29;16.1;26;17;15;10;1;14;26;53.8;12;15;6;9;20;46;43;1;
Kingsley Ehizibue;28;0.7;0;0;0;0;0;0;0;;0;1;0;1;2;2;1;0;
Kingsley Ehizibue;28;17.1;47;31;28;13;6;29;45;64.4;16;21;3;18;10;57;42;1;
Tyronne Ebuehi;28;21.4;22;14;11;7;4;9;13;69.2;4;23;12;11;12;34;79;1;
Enzo Ebosse;24;10.3;15;9;11;4;0;9;13;69.2;4;27;6;21;11;26;29;0;
Festy Ebosele;21;4.6;15;10;8;7;0;4;10;40.0;6;5;0;5;2;17;5;0;
Jean-Kevin Duverne;26;27.9;72;38;44;24;4;42;73;57.5;31;33;5;28;28;100;65;1;
Lewis Dunk;32;36.0;30;19;19;9;2;18;41;43.9;23;37;27;10;34;64;81;1;
Denzel Dumfries;27;24.6;35;18;17;13;5;22;34;64.7;12;33;9;24;12;47;26;0;
Domingos Duarte;28;29.5;26;18;21;5;0;19;26;73.1;7;29;23;6;39;65;145;0;
Cody Drameh;22;0.8;5;4;0;4;1;2;3;66.7;1;0;0;0;1;6;1;0;
Gabriel Dos Santos;26;37.9;48;30;29;15;4;18;27;66.7;9;49;26;23;32;80;125;2;
Giulio Donati;33;4.7;4;1;1;1;2;3;6;50.0;3;3;1;2;4;8;11;0;
Carlos Dominguez;22;1.2;1;1;0;1;0;1;2;50.0;1;1;1;0;0;1;7;0;
Josh Doig;21;15.0;19;8;6;7;6;6;16;37.5;10;25;6;19;11;30;13;1;
Matt Doherty;31;0.2;0;0;0;0;0;0;0;;0;2;0;2;0;0;0;0;
Danilho Doekhi;25;24.6;38;23;21;17;0;14;26;53.8;12;27;12;15;29;67;93;0;
Dodô;25;25.9;40;22;20;14;6;22;46;47.8;24;26;2;24;25;65;37;0;
Berat Djimsiti;30;20.0;34;19;21;13;0;17;25;68.0;8;17;7;10;36;70;74;1;
Alexander Djiku;29;29.7;53;36;37;16;0;26;46;56.5;20;45;19;26;66;119;151;3;
Koffi Djidji;31;26.9;50;25;32;17;1;18;32;56.3;14;29;14;15;34;84;72;0;
Djené;32;31.6;41;28;23;17;1;22;38;57.9;16;25;10;15;42;83;81;1;
Tiago Djaló;23;22.4;31;21;23;7;1;13;20;65.0;7;17;11;6;23;54;60;1;
Axel Disasi;25;37.0;30;20;13;13;4;13;27;48.1;14;51;31;20;56;86;112;2;
Issa Diop;26;22.4;28;19;18;9;1;17;32;53.1;15;24;17;7;35;63;86;0;
Sinaly Diomande;22;21.7;42;24;26;15;1;31;49;63.3;18;26;13;13;49;91;75;1;
Federico Dimarco;26;23.0;31;25;6;18;7;9;19;47.4;10;15;4;11;18;49;20;0;
Lucas Digne;30;16.7;30;12;20;9;1;20;33;60.6;13;18;5;13;18;48;45;0;
Eric Dier;29;31.3;30;19;16;12;2;9;19;47.4;10;41;24;17;35;65;112;2;
Rúben Dias;26;22.2;21;13;10;10;1;11;18;61.1;7;21;13;8;18;39;56;1;
Moussa Diarra;23;13.6;20;9;9;9;2;9;15;60.0;6;25;10;15;19;39;27;1;
Ismael Diallo;26;24.2;46;33;35;9;2;35;63;55.6;28;26;12;14;30;76;46;1;
Ibrahim Diakité;20;1.5;3;3;3;0;0;2;3;66.7;1;0;0;0;5;8;6;0;
Bafodé Diakité;22;29.5;54;35;23;24;7;32;57;56.1;25;37;8;29;17;71;58;0;
Mouctar Diakhaby;27;27.2;30;16;19;11;0;13;20;65.0;7;30;17;13;20;50;111;2;
Giovanni Di Lorenzo;30;36.2;60;29;33;19;8;25;49;51.0;24;30;9;21;30;90;60;0;
Sergiño Dest;23;3.7;12;6;3;5;4;3;4;75.0;1;1;0;1;4;16;2;0;
Mikkel Desler;28;25.1;71;38;36;27;8;43;67;64.2;24;35;6;29;36;107;48;2;
Kastriot Dermaku;31;0.4;0;0;0;0;0;0;0;;0;0;0;0;0;0;0;0;
Fabio Depaoli;26;24.1;48;28;25;16;7;25;44;56.8;19;32;6;26;18;66;33;3;
Sepp van den Berg;22;7.7;5;4;2;2;1;1;4;25.0;3;8;5;3;13;18;33;2;
Merih Demiral;25;17.0;41;29;30;11;0;26;36;72.2;10;24;7;17;24;65;57;1;
Fran Delgado;22;0.1;0;0;0;0;0;0;0;;0;0;0;0;0;0;0;0;
Koni De Winter;21;11.4;14;9;11;3;0;5;13;38.5;8;14;12;2;6;20;65;0;
Thibault De Smet;25;19.5;24;17;10;14;0;11;37;29.7;26;28;5;23;20;44;40;1;
Lorenzo De Silvestri;35;7.5;3;2;2;0;1;3;7;42.9;4;6;5;1;3;6;20;0;
Mattia De Sciglio;31;11.6;14;7;8;3;3;9;14;64.3;5;9;3;6;4;18;20;0;
Craig Dawson;33;15.7;9;6;6;3;0;4;7;57.1;3;31;23;8;12;21;74;2;
Craig Dawson;33;8.0;10;6;8;2;0;4;6;66.7;2;9;6;3;6;16;26;0;
Paweł Dawidowicz;28;18.1;48;31;28;17;3;22;31;71.0;9;14;9;5;23;71;71;0;
Ben Davies;30;25.4;28;11;13;13;2;14;26;53.8;12;17;8;9;18;46;72;0;
Alphonso Davies;23;22.7;45;28;25;13;7;18;39;46.2;21;28;4;24;24;69;24;4;
Matteo Darmian;34;22.5;56;30;29;15;12;31;47;66.0;16;33;5;28;21;77;36;0;
Achraf Dari;24;14.6;21;14;15;5;1;14;20;70.0;6;16;10;6;19;40;65;2;
Dante;40;36.7;70;40;45;21;4;36;59;61.0;23;52;31;21;47;117;125;2;
Kevin Danso;25;35.9;37;19;25;11;1;19;30;63.3;11;48;34;14;33;70;124;0;
Danilo;32;35.4;92;62;61;23;8;52;73;71.2;21;39;20;19;47;139;114;1;
Flavius Daniliuc;22;1.0;2;0;2;0;0;1;1;100.0;0;4;1;3;0;2;1;0;
Flavius Daniliuc;22;24.4;57;29;37;17;3;26;47;55.3;21;30;13;17;29;86;76;0;
Diogo Dalot;24;23.9;54;41;40;13;1;33;45;73.3;12;25;7;18;37;91;55;2;
Damien Da Silva;35;3.8;8;7;5;3;0;3;3;100.0;0;4;3;1;5;13;12;0;
Danilo D'Ambrosio;35;8.1;25;17;17;7;1;15;27;55.6;12;12;4;8;10;35;17;0;
Braian Cufré;27;2.4;5;2;2;1;2;2;5;40.0;3;2;1;1;2;7;1;0;
Jorge Cuenca;24;5.6;9;7;7;2;0;4;7;57.1;3;10;8;2;6;15;44;0;
Marc Cucurella;25;18.6;66;33;40;15;11;30;60;50.0;30;28;8;20;16;82;48;1;
Juan Cruz Armada;31;22.9;24;14;17;4;3;13;23;56.5;10;21;8;13;13;37;58;0;
Aaron Cresswell;34;24.8;21;11;12;7;2;12;31;38.7;19;21;11;10;27;48;56;0;
Nicolas Cozza;24;1.1;3;3;1;2;0;2;3;66.7;1;3;1;2;0;3;0;0;
Nicolas Cozza;24;14.2;38;21;27;9;2;26;38;68.4;12;11;5;6;21;59;35;1;
Soumaïla Coulibaly;20;0.5;0;0;0;0;0;0;0;;0;0;0;0;0;0;0;1;
Vladimír Coufal;31;23.7;58;31;37;15;6;36;51;70.6;15;24;6;18;38;96;70;0;
Logan Costa;22;4.6;9;4;7;1;1;6;9;66.7;3;6;3;3;4;13;12;0;
Jaume Costa;35;28.9;50;34;26;17;7;29;51;56.9;22;13;5;8;22;72;44;1;
Danny da Costa;30;13.7;20;16;7;8;5;12;20;60.0;8;22;3;19;9;29;26;0;
Thierry Correia;24;22.3;71;52;46;22;3;31;54;57.4;23;25;2;23;24;95;54;2;
Sébastien Corchia;33;8.7;16;6;10;2;4;11;22;50.0;11;9;3;6;14;30;21;0;
Diego Coppola;20;13.1;25;17;15;10;0;11;24;45.8;13;20;6;14;14;39;38;0;
Copete;24;24.5;53;28;35;16;2;26;36;72.2;10;38;17;21;44;97;111;2;
Liam Cooper;32;15.8;38;23;27;9;2;23;36;63.9;13;16;8;8;34;72;57;3;
Steve Cook;32;10.6;8;4;4;4;0;5;7;71.4;2;16;11;5;12;20;51;0;
Andrea Conti;29;0.3;0;0;0;0;0;0;0;;0;0;0;0;0;0;0;0;
Abdu Conté;25;14.6;25;17;14;8;3;12;22;54.5;10;13;6;7;6;31;25;0;
Eray Cömert;25;18.6;35;23;24;10;1;17;33;51.5;16;23;8;15;29;64;76;1;
Levi Colwill;20;13.6;8;7;4;4;0;4;9;44.4;5;5;3;2;15;23;37;1;
Nathan Collins;22;20.2;27;15;19;8;0;15;24;62.5;9;35;28;7;21;48;84;0;
Omar Colley;31;15.4;17;10;10;7;0;9;12;75.0;3;9;5;4;22;39;69;1;
Séamus Coleman;35;18.4;35;26;21;10;4;19;29;65.5;10;14;7;7;22;57;58;2;
Alexandre Coeff;31;6.5;10;5;6;4;0;4;9;44.4;5;9;4;5;8;18;35;1;
Nicolò Cocetta;20;0.4;0;0;0;0;0;0;1;0.0;1;1;1;0;1;1;1;0;
Conor Coady;30;23.3;14;9;8;6;0;7;15;46.7;8;21;17;4;14;28;88;3;
Nathaniel Clyne;32;18.2;27;16;13;9;5;14;23;60.9;9;22;4;18;19;46;34;0;
Jonathan Clauss;31;28.8;46;28;21;16;9;23;52;44.2;29;29;4;25;31;77;40;2;
Souleymane Cissé;21;0.4;1;1;1;0;0;1;1;100.0;0;1;1;0;1;2;2;0;
Víctor Chust;23;10.7;9;6;7;2;0;4;7;57.1;3;8;3;5;10;19;53;0;
Andreas Christensen;27;19.6;20;15;9;11;0;10;16;62.5;6;14;12;2;21;41;47;0;
Vlad Chiricheș;34;10.9;35;20;27;7;1;16;24;66.7;8;36;23;13;22;57;44;0;
Fabio Chiarodia;18;0.7;0;0;0;0;0;0;0;;0;1;0;1;2;2;4;0;
Ilyes Cheti;28;2.3;6;4;4;0;2;5;8;62.5;3;5;1;4;4;10;7;0;
Shea Charles;20;0.3;4;0;4;0;0;1;1;100.0;0;0;0;0;1;5;2;0;
Brendan Chardonnet;29;27.7;45;27;27;18;0;20;38;52.6;18;40;19;21;63;108;86;1;
Timothy Chandler;33;1.0;2;2;2;0;0;2;2;100.0;0;1;0;1;0;2;3;0;
Trevoh Chalobah;24;17.9;31;20;22;6;3;24;34;70.6;10;17;7;10;24;55;56;1;
El Chadaille Bitshiabu;18;6.5;10;7;7;2;1;3;12;25.0;9;9;7;2;9;19;13;3;
Julian Chabot;25;20.0;36;23;19;14;3;20;35;57.1;15;30;18;12;41;77;105;0;
Fabien Centonze;27;18.8;58;37;30;22;6;30;42;71.4;12;24;7;17;44;102;55;1;
Álex Centelles;26;12.5;22;14;16;3;3;16;22;72.7;6;13;2;11;11;33;40;0;
Zeki Çelik;26;16.7;42;21;19;21;2;24;41;58.5;17;33;6;27;14;56;36;2;
Federico Ceccherini;31;15.8;25;19;15;9;1;13;23;56.5;10;17;10;7;19;44;55;0;
Pietro Ceccaroni;28;0.5;0;0;0;0;0;0;0;;0;1;1;0;3;3;2;0;
Maximiliano Caufriez;26;24.7;40;24;31;8;1;20;28;71.4;8;33;18;15;34;74;70;0;
Catena;29;34.5;29;14;23;4;2;13;27;48.1;14;32;25;7;28;57;159;1;
Jonny Castro;29;14.0;34;15;23;10;1;18;37;48.6;19;26;5;21;14;48;28;2;
Jean-Charles Castelletto;28;28.5;43;26;29;12;2;22;36;61.1;14;35;22;13;58;101;90;0;
Timothy Castagne;28;36.2;87;44;53;27;7;41;84;48.8;43;50;13;37;43;130;110;0;
Tommaso Cassandro;23;0.1;1;1;0;1;0;0;0;;0;1;1;0;0;1;0;0;
Matty Cash;26;20.2;55;32;36;15;4;26;37;70.3;11;20;5;15;26;81;43;0;
Nicolò Casale;25;27.1;42;20;28;14;0;22;34;64.7;12;25;17;8;17;59;73;1;
Dani Carvajal;31;19.8;32;18;15;12;5;18;35;51.4;17;24;6;18;15;47;49;0;
Carmona;21;5.9;13;11;5;3;5;9;16;56.3;7;10;6;4;7;20;17;1;
Diego Carlos;30;2.3;1;0;0;1;0;0;1;0.0;1;2;2;0;1;2;2;0;
Carlos;24;34.3;73;38;42;23;8;33;54;61.1;21;24;6;18;24;97;85;1;
Igor Carioca;27;5.1;18;11;12;2;4;12;21;57.1;9;7;0;7;5;23;17;0;
Isaac Carcelen;30;24.4;69;51;41;22;6;41;63;65.1;22;35;11;24;19;88;80;1;
Andrea Carboni;22;1.9;3;2;2;0;1;2;5;40.0;3;3;2;1;3;6;2;1;
Ander Capa;31;1.2;1;1;1;0;0;1;5;20.0;4;5;0;5;0;1;2;0;
João Cancelo;29;14.2;29;21;16;9;4;17;24;70.8;7;7;1;6;19;48;9;1;
Andrea Cambiaso;23;24.1;57;34;34;20;3;28;65;43.1;37;26;2;24;26;83;33;1;
Ousmane Camara;20;5.8;10;6;5;5;0;5;12;41.7;7;4;2;2;11;21;15;0;
Alexander Callens;31;1.3;3;3;2;1;0;3;4;75.0;1;3;1;2;1;4;9;0;
Kerim Calhanoglu;21;0.7;2;1;2;0;0;2;2;100.0;0;1;0;1;0;2;3;0;
Duje Ćaleta-Car;27;0.1;0;0;0;0;0;0;0;;0;0;0;0;0;0;1;0;
Duje Ćaleta-Car;27;10.5;14;10;9;4;1;6;9;66.7;3;15;11;4;15;29;65;1;
Luca Caldirola;32;26.1;26;14;19;4;3;13;26;50.0;13;32;18;14;25;51;66;1;
Mattia Caldara;29;13.9;23;14;10;11;2;9;20;45.0;11;23;16;7;17;40;88;2;
Davide Calabria;27;18.8;71;44;31;32;8;38;61;62.3;23;22;7;15;25;96;34;0;
Cala;34;1.5;2;1;1;1;0;1;2;50.0;1;2;1;1;1;3;12;0;
Anthony Caci;26;22.6;58;33;32;20;6;28;42;66.7;14;28;4;24;54;112;40;0;
Liberato Cacace;23;6.5;25;10;12;8;5;9;15;60.0;6;15;7;8;4;29;16;0;
Leandro Cabrera;32;29.7;46;24;34;12;0;28;43;65.1;15;37;23;14;43;89;114;2;
Juan Cabal;22;4.9;10;6;7;3;0;7;12;58.3;5;8;5;3;13;23;12;0;
Leonardo Buta;21;0.2;1;1;0;1;0;0;0;;0;0;0;0;0;1;0;0;
Aurélio Buta;26;14.6;33;19;15;13;5;15;27;55.6;12;18;1;17;9;42;34;0;
Maxime Busi;24;11.6;21;16;9;11;1;13;29;44.8;16;14;6;8;14;35;24;0;
Dan Burn;31;34.6;60;38;29;23;8;34;67;50.7;33;42;16;26;32;92;120;2;
Alessandro Buongiorno;24;30.2;38;25;22;16;0;16;31;51.6;15;38;19;19;60;98;105;2;
Santiago Bueno;25;33.4;63;38;43;19;1;24;36;66.7;12;34;22;12;31;94;105;2;
Hugo Bueno;21;14.6;33;16;23;6;4;17;33;51.5;16;14;1;13;10;43;36;0;
Lewis Brunt;23;0.3;0;0;0;0;0;0;0;;0;0;0;0;0;0;2;0;
Cédric Brunner;29;25.7;39;27;26;11;2;30;45;66.7;15;24;7;17;43;82;79;0;
John Brooks;30;15.0;18;12;10;8;0;13;18;72.2;5;17;12;5;10;28;105;0;
Dylan Bronn;28;18.7;34;18;17;16;1;20;30;66.7;10;32;20;12;20;54;58;1;
Gleison Bremer;26;29.3;29;20;23;5;1;19;26;73.1;7;44;22;22;42;71;120;2;
James Bree;26;4.1;5;3;4;1;0;3;4;75.0;1;3;1;2;6;11;11;0;
Lilian Brassier;24;34.4;42;30;31;8;3;23;32;71.9;9;42;19;23;53;95;132;1;
Juan Brandáriz;24;16.5;29;16;18;9;2;14;23;60.9;9;20;7;13;15;44;53;0;
Domagoj Bradarić;24;25.0;26;19;14;8;4;7;16;43.8;9;20;5;15;21;47;44;0;
Wassim Boullif;18;1.6;3;1;3;0;0;2;3;66.7;1;5;4;1;0;3;3;0;
Franci Bouebari;20;0.8;3;0;1;2;0;3;5;60.0;2;0;0;0;2;5;2;0;
Kenji-Van Boto;27;2.0;3;2;2;0;1;2;4;50.0;2;0;0;0;1;4;3;0;
Sven Botman;23;34.7;38;24;31;7;0;22;28;78.6;6;44;24;20;34;72;126;2;
Sebastiaan Bornauw;24;21.4;29;17;17;10;2;16;22;72.7;6;27;12;15;31;60;83;1;
Neto Borges;27;31.5;75;45;45;20;10;46;75;61.3;29;45;11;34;41;116;62;1;
Leonardo Bonucci;36;9.8;5;4;1;4;0;2;4;50.0;2;12;8;4;13;18;29;0;
Kevin Bonifazi;27;10.0;13;8;7;6;0;6;12;50.0;6;11;8;3;12;25;39;0;
Willy Boly;32;7.6;13;6;8;3;2;8;13;61.5;5;13;4;9;12;25;45;0;
Jérôme Boateng;35;4.8;3;0;2;1;0;2;6;33.3;4;8;5;3;6;9;16;0;
Miha Blažič;30;22.0;8;6;8;0;0;7;15;46.7;8;25;19;6;22;30;80;1;
Samuele Birindelli;24;15.6;35;19;21;10;4;18;29;62.1;11;28;8;20;16;51;30;0;
Cristiano Biraghi;31;28.3;65;38;29;29;7;32;65;49.2;33;32;7;25;14;79;42;1;
Jaka Bijol;24;30.3;39;23;32;7;0;16;27;59.3;11;41;25;16;29;68;165;0;
Pedro Bigas;33;22.4;37;20;30;7;0;18;29;62.1;11;25;14;11;33;70;95;0;
Ermin Bičakčić;33;2.9;8;4;6;1;1;2;6;33.3;4;4;3;1;5;13;14;0;
Giulian Biancone;23;0.2;2;1;2;0;0;1;1;100.0;0;0;0;0;1;3;0;0;
Matteo Bianchetti;30;23.7;32;19;21;9;2;20;32;62.5;12;31;17;14;20;52;111;0;
Owen Bevan;20;0.1;0;0;0;0;0;0;0;;0;0;0;0;0;0;0;0;
Victor Bernth Kristiansen;21;9.9;38;23;18;16;4;22;30;73.3;8;16;4;12;3;41;26;0;
Quentin Bernard;34;7.0;9;7;4;2;3;7;15;46.7;8;9;1;8;15;24;17;0;
Bartosz Bereszyński;31;1.8;3;2;1;1;1;2;2;100.0;0;4;0;4;3;6;3;0;
Bartosz Bereszyński;31;13.3;28;18;15;11;2;17;26;65.4;9;18;4;14;21;49;25;0;
Yuri Berchiche;33;26.7;56;32;28;20;8;35;59;59.3;24;37;12;25;40;96;59;1;
Ramy Bensebaini;28;27.6;34;21;21;10;3;26;39;66.7;13;44;14;30;36;70;98;1;
Marco Benassi;29;1.0;3;3;2;0;1;3;4;75.0;1;0;0;0;1;4;1;0;
Jeanöel Belocian;18;5.6;10;7;3;5;2;5;9;55.6;4;6;3;3;6;16;11;0;
Héctor Bellerín;28;1.6;2;0;0;2;0;2;3;66.7;1;2;0;2;3;5;2;0;
Raoul Bellanova;23;5.5;14;6;11;2;1;9;14;64.3;5;6;1;5;4;18;14;0;
Armel Bella Kotchap;22;20.9;37;17;28;9;0;15;20;75.0;5;29;12;17;44;81;110;0;
Stefan Bell;32;26.6;43;28;32;10;1;22;44;50.0;22;42;15;27;44;87;133;0;
Jan Bednarek;27;1.1;3;3;0;3;0;1;1;100.0;0;3;1;2;2;5;5;0;
Jan Bednarek;27;18.6;27;21;20;7;0;12;16;75.0;4;38;27;11;49;76;87;0;
Rodrigo Becão;27;27.6;70;36;50;17;3;40;53;75.5;13;44;24;20;26;96;68;2;
Brian Bayeye;23;0.7;3;0;3;0;0;1;1;100.0;0;1;1;0;1;4;2;0;
Timo Baumgartl;27;6.2;11;6;5;4;2;5;18;27.8;13;12;4;8;2;13;14;0;
Maximilian Bauer;23;20.5;31;17;18;12;1;17;34;50.0;17;25;9;16;23;54;79;1;
Alessandro Bastoni;24;24.0;41;20;20;14;7;11;27;40.7;16;27;13;14;24;65;45;0;
Federico Baschirotto;27;37.0;40;30;35;5;0;22;36;61.1;14;45;29;16;36;76;192;0;
Melvin Bard;23;27.3;96;60;61;29;6;59;89;66.3;30;35;4;31;64;160;40;1;
Tommaso Barbieri;21;1.2;3;3;3;0;0;3;8;37.5;5;3;0;3;0;3;2;0;
Abdoulaye Bamba;33;15.2;22;12;15;5;2;16;19;84.2;3;7;3;4;18;40;38;0;
Fodé Ballo-Touré;26;5.8;14;9;7;6;1;7;10;70.0;3;11;3;8;2;16;3;0;
Iván Balliu;31;35.9;52;29;26;20;6;18;30;60.0;12;26;3;23;25;77;72;1;
Leonardo Balerdi;24;29.3;57;37;43;12;2;32;45;71.1;13;48;29;19;63;120;91;1;
Mikel Balenziaga;35;1.3;4;4;1;2;1;4;4;100.0;0;0;0;0;1;5;2;0;
Alejandro Balde;20;27.5;42;30;22;16;4;24;41;58.5;17;25;3;22;12;54;17;1;
Dénys Bain;30;1.4;4;3;3;1;0;1;2;50.0;1;2;1;1;2;6;4;0;
Eric Bailly;29;6.0;13;10;6;6;1;7;7;100.0;0;15;12;3;12;25;18;1;
Jaime Báez;28;1.1;4;2;3;0;1;3;6;50.0;3;0;0;0;0;4;2;1;
Benoît Badiashile;22;9.3;10;8;6;4;0;5;10;50.0;5;9;6;3;17;27;40;1;
Benoît Badiashile;22;10.1;14;8;10;4;0;9;14;64.3;5;5;2;3;16;30;34;1;
Loïc Bade;23;1.0;1;1;1;0;0;0;0;;0;0;0;0;1;2;3;0;
Loïc Bade;23;16.1;27;20;23;3;1;17;30;56.7;13;21;13;8;23;50;77;0;
Srđan Babić;27;33.3;28;18;20;8;0;15;32;46.9;17;34;22;12;29;57;124;1;
Sanoussy Ba;19;0.0;0;0;0;0;0;0;0;;0;0;0;0;0;0;0;0;
César Azpilicueta;34;17.0;43;25;23;15;5;22;37;59.5;15;26;5;21;19;62;54;1;
Luke Ayling;32;22.8;66;37;42;15;9;42;85;49.4;43;34;11;23;26;92;52;2;
Kaan Ayhan;29;6.1;10;4;6;4;0;7;7;100.0;0;5;4;1;5;15;26;1;
Cédric Avinel;37;19.9;13;7;8;5;0;8;12;66.7;4;20;13;7;15;28;91;1;
Serge Aurier;31;21.6;64;41;41;18;5;23;33;69.7;10;34;11;23;29;93;75;0;
Ludwig Augustinsson;29;1.5;2;1;2;0;0;1;3;33.3;2;1;0;1;1;3;3;0;
Ludwig Augustinsson;29;0.9;1;1;1;0;0;0;0;;0;0;0;0;0;1;1;0;
Tommaso Augello;29;34.0;17;14;13;2;2;9;20;45.0;11;23;7;16;17;34;61;1;
Lorenz Assignon;23;2.9;6;2;4;2;0;2;4;50.0;2;6;0;6;2;8;9;0;
Ronald Araújo;24;20.0;26;18;12;13;1;6;9;66.7;3;15;7;8;12;38;41;1;
Valentin Antov;23;3.4;6;5;3;3;0;1;5;20.0;4;5;4;1;4;10;14;1;
Waldemar Anton;27;32.6;49;27;27;19;3;27;51;52.9;24;44;16;28;38;87;123;2;
Fabrizio Angileri;29;6.5;12;9;8;3;1;10;17;58.8;7;8;3;5;7;19;10;0;
Angeliño;26;29.1;40;24;19;18;3;23;37;62.2;14;32;6;26;25;65;67;0;
Joachim Andersen;27;30.9;42;22;30;12;0;16;32;50.0;16;28;13;15;24;66;188;0;
Bruno Amione;21;23.2;50;33;36;14;0;19;43;44.2;24;26;11;15;25;75;62;1;
Bruno Amione;21;0.6;1;1;1;0;0;1;2;50.0;1;1;0;1;0;1;4;0;
Kelvin Amian;25;26.3;54;32;33;12;9;24;31;77.4;7;34;12;22;22;76;87;1;
Jordan Amavi;29;2.2;3;2;3;0;0;1;3;33.3;2;3;0;3;4;7;7;0;
Daniel Amartey;29;17.9;19;8;13;5;1;12;14;85.7;2;24;17;7;8;27;71;0;
Yeray Álvarez;28;25.9;34;23;26;7;1;24;31;77.4;7;23;13;10;48;82;101;0;
Gastón Álvarez;23;16.7;38;30;24;9;5;23;42;54.8;19;15;5;10;15;53;35;0;
Mickaël Alphonse;34;15.1;35;23;20;11;4;20;33;60.6;13;17;5;12;35;70;44;1;
Marcos Alonso;33;13.0;15;10;10;5;0;9;12;75.0;3;14;10;4;11;26;32;0;
Trent Alexander-Arnold;25;32.5;57;40;32;16;9;42;79;53.2;37;25;7;18;43;100;41;2;
Omar Alderete;27;22.7;35;20;21;14;0;28;40;70.0;12;23;16;7;26;61;85;0;
Raúl Albiol;38;23.5;25;17;17;6;2;14;18;77.8;4;17;13;4;14;39;111;0;
Jordi Alba;34;15.8;25;18;13;11;1;12;28;42.9;16;12;5;7;11;36;23;0;
David Alaba;31;20.4;15;11;8;4;3;9;15;60.0;6;18;9;9;14;29;37;1;
Kevin Akpoguma;28;21.7;75;44;45;27;3;32;45;71.1;13;45;16;29;24;99;70;1;
Sergio Akieme;26;25.5;27;16;19;6;2;12;22;54.5;10;22;6;16;14;41;41;0;
Nathan Aké;28;20.8;26;12;15;9;2;11;15;73.3;4;20;10;10;20;46;48;0;
Manuel Akanji;28;25.4;36;25;15;18;3;23;36;63.9;13;27;9;18;16;52;33;0;
Kristoffer Ajer;25;8.5;11;8;5;4;2;9;16;56.3;7;6;5;1;7;18;22;0;
Emanuel Aiwum;23;18.4;55;34;36;17;2;33;47;70.2;14;28;16;12;25;80;52;3;
Rayan Aït Nouri;22;12.0;33;20;25;7;1;9;15;60.0;6;3;0;3;9;42;28;0;
Ola Aina;27;9.7;17;13;5;8;4;9;15;60.0;6;12;2;10;11;28;26;0;
Joseph Aidoo;28;34.7;51;36;33;17;1;16;28;57.1;12;26;14;12;31;82;150;0;
Ruben Aguilar;30;13.0;19;9;7;7;5;8;22;36.4;14;13;1;12;18;37;28;1;
Nayef Aguerd;27;17.7;27;18;18;8;1;13;20;65.0;7;26;24;2;18;45;79;2;
Emmanuel Agbadou;26;26.5;71;49;53;16;2;42;65;64.6;23;30;14;16;32;103;107;3;
Tosin Adarabioyo;26;23.2;30;13;22;6;2;16;23;69.6;7;20;15;5;26;56;140;1;
Marcos Acuña;32;21.2;57;36;34;17;6;30;42;71.4;12;16;5;11;23;80;36;0;
Francesco Acerbi;35;26.9;33;19;22;7;4;20;27;74.1;7;25;18;7;41;74;85;2;
Abner;23;6.7;12;9;9;2;1;7;16;43.8;9;8;2;6;8;20;24;0;
Yunis Abdelhamid;36;37.0;82;50;47;33;2;39;52;75.0;13;65;27;38;64;146;116;1;
James Abankwah;19;0.7;1;1;0;1;0;0;0;;0;4;2;2;0;1;5;0;
Nadir Zortea;24;2.5;10;5;3;7;0;3;4;75.0;1;4;0;4;0;10;4;0;
Mehdi Zeffane;31;7.3;12;7;5;7;0;4;21;19.0;17;14;6;8;22;34;12;0;
Akim Zedadka;28;3.9;1;1;1;0;0;0;2;0.0;2;3;0;3;2;3;6;0;
Oliver Zandén;22;1.6;2;1;1;0;1;2;5;40.0;3;0;0;0;1;3;7;0;
Axel Witsel;34;25.1;36;22;22;11;3;17;31;54.8;14;20;11;9;23;59;76;0;
Rúben Vinagre;24;0.3;2;2;1;1;0;1;2;50.0;1;0;0;0;0;2;1;0;
Clément Vidal;23;21.1;25;15;14;11;0;18;38;47.4;20;27;16;11;27;52;73;1;
Kevin Vázquez;30;4.9;13;8;5;7;1;8;12;66.7;4;4;1;3;2;15;8;0;
Jesus Vazquez;20;3.4;13;8;9;1;3;6;11;54.5;5;4;0;4;1;14;8;0;
Vanderson;22;24.6;84;48;36;34;14;44;75;58.7;31;36;9;27;48;132;36;1;
Filippo Terracciano;20;9.1;20;13;11;7;2;15;20;75.0;5;7;4;3;10;30;14;0;
Nuno Tavares;23;26.1;56;30;19;24;13;28;55;50.9;27;32;4;28;15;71;25;0;
Niklas Tauer;22;1.0;2;1;2;0;0;1;3;33.3;2;2;1;1;2;4;4;0;
Damián Suárez;35;21.6;49;33;23;19;7;26;47;55.3;21;40;0;40;15;64;36;0;
John Stones;29;20.5;23;13;11;8;4;7;10;70.0;3;17;10;7;9;32;40;0;
Kostas Stafylidis;30;11.6;27;16;13;8;6;10;24;41.7;14;21;8;13;20;47;31;1;
Tim Skarke;27;0.6;1;1;0;0;1;0;0;;0;1;0;1;0;1;0;0;
Daley Sinkgraven;28;3.8;10;7;7;3;0;7;9;77.8;2;8;4;4;5;15;7;0;
Kiliann Sildillia;21;22.0;33;20;10;19;4;18;30;60.0;12;24;9;15;21;54;47;1;
Stephan El Shaarawy;31;16.9;21;9;8;10;3;6;22;27.3;16;11;1;10;15;36;11;0;
Kingsley Schindler;30;12.1;23;12;13;8;2;18;28;64.3;10;14;2;12;15;38;24;0;
Matteo Ruggeri;21;9.2;17;12;5;9;3;8;16;50.0;8;14;3;11;12;29;16;0;
Rubén;22;9.9;30;15;18;9;3;20;29;69.0;9;14;4;10;18;48;18;0;
Sergi Roberto;31;14.5;22;15;12;6;4;7;18;38.9;11;15;7;8;11;33;16;0;
Jaïro Riedewald;27;0.7;2;1;2;0;0;0;1;0.0;1;2;0;2;0;2;4;0;
Rayan Raveloson;26;27.0;38;23;21;16;1;23;33;69.7;10;43;12;31;39;77;70;0;
David Raum;25;18.7;39;25;23;12;4;17;29;58.6;12;24;6;18;16;55;26;1;
Lilian Raolisoa;23;1.9;11;9;6;3;2;7;10;70.0;3;3;1;2;3;14;5;0;
Pedro Porro;24;12.6;25;16;8;15;2;14;39;35.9;25;25;2;23;15;40;24;1;
Ivan Perišić;34;23.4;42;24;25;10;7;27;47;57.4;20;29;7;22;22;64;49;1;
Roberto Pereyra;32;31.3;36;20;21;12;3;16;44;36.4;28;20;5;15;16;52;28;0;
Ricardo Pereira;30;5.0;11;7;8;3;0;7;17;41.2;10;8;2;6;4;15;20;0;
Danilo Pereira;32;26.8;32;17;15;14;3;19;26;73.1;7;26;19;7;36;68;59;1;
Rubén Peña;32;14.2;32;18;10;18;4;20;41;48.8;21;23;8;15;17;49;31;0;
Pedrosa;25;2.5;5;1;5;0;0;4;7;57.1;3;1;1;0;5;10;3;0;
Mads Pedersen;27;20.4;44;23;31;11;2;22;33;66.7;11;32;9;23;20;64;41;1;
Nathan Patterson;22;14.2;49;24;32;13;4;29;53;54.7;24;24;4;20;15;64;45;0;
Papa Ndiaga Yade;23;6.3;10;6;6;2;2;7;22;31.8;15;10;2;8;8;18;10;0;
Nikolas Nartey;23;5.3;11;6;7;3;1;5;9;55.6;4;9;0;9;4;15;12;0;
Joakim Mæhle;26;24.6;32;18;12;7;13;22;39;56.4;17;29;6;23;24;56;26;0;
Johan Mojica;31;3.0;6;3;5;1;0;2;3;66.7;1;3;2;1;4;10;5;0;
Tobias Mohr;28;9.3;8;5;3;5;0;2;7;28.6;5;14;5;9;8;16;19;0;
Maximilian Mittelstädt;26;9.4;39;20;31;6;2;17;39;43.6;22;13;2;11;26;65;27;0;
Chrislain Matsima;21;2.5;0;0;0;0;0;0;0;;0;3;3;0;2;2;7;0;
Erhan Mašović;25;24.2;50;31;28;21;1;30;51;58.8;21;30;14;16;27;77;79;0;
Ainsley Maitland-Niles;26;15.6;45;24;23;18;4;28;44;63.6;16;28;7;21;22;67;45;1;
Deiver Machado;30;24.3;45;26;18;20;7;21;34;61.8;13;21;4;17;21;66;27;0;
Dimitri Liénard;35;17.1;46;29;20;18;8;34;57;59.6;23;28;4;24;16;62;24;0;
Rico Lewis;19;10.0;16;9;9;5;2;6;11;54.5;5;8;4;4;6;22;13;1;
Darko Lazović;33;24.9;24;13;9;12;3;13;29;44.8;16;14;3;11;16;40;19;0;
Toni Lato;26;10.2;23;11;9;12;2;9;21;42.9;12;10;1;9;6;29;14;0;
Yasser Larouci;22;20.0;23;13;13;8;2;15;24;62.5;9;15;1;14;26;49;46;0;
Filip Kostić;31;0.8;2;0;1;1;0;0;0;;0;0;0;0;1;3;0;0;
Josan;34;12.0;25;20;20;5;0;14;27;51.9;13;8;0;8;7;32;15;1;
Dany Jean;21;0.1;0;0;0;0;0;0;1;0.0;1;1;0;1;0;0;0;0;
Tony Jantschke;33;1.1;2;1;1;1;0;1;1;100.0;0;5;3;2;0;2;5;0;
Reece James;24;13.8;31;20;10;18;3;15;19;78.9;4;17;2;15;12;43;23;0;
Kristijan Jakić;26;16.2;33;21;19;12;2;22;41;53.7;19;32;10;22;14;47;49;1;
Iglesias;25;23.8;61;35;40;18;3;33;63;52.4;30;40;5;35;21;82;91;1;
Iago;26;17.8;34;16;20;10;4;11;29;37.9;18;18;5;13;17;51;53;0;
Martin Hongla;25;14.5;18;13;13;5;0;11;21;52.4;10;15;12;3;8;26;46;1;
Omar El Hilali;20;1.0;3;2;3;0;0;1;2;50.0;1;1;0;1;1;4;6;0;
Benjamin Henrichs;26;24.3;73;46;41;29;3;43;66;65.2;23;48;4;44;35;108;46;0;
Achraf Hakimi;25;22.8;54;34;19;20;15;31;59;52.5;28;34;2;32;16;70;19;0;
Massadio Haïdara;31;18.6;24;16;9;9;6;12;24;50.0;12;26;9;17;36;60;39;1;
Christian Günter;30;30.5;29;21;18;9;2;13;43;30.2;30;22;4;18;16;45;41;0;
Josuha Guilavogui;33;13.1;18;11;7;10;1;6;17;35.3;11;19;13;6;23;41;52;0;
Raphaël Guerreiro;30;25.4;36;20;13;15;8;21;34;61.8;13;21;2;19;36;72;23;0;
Nemanja Gudelj;32;30.9;43;33;22;18;3;20;33;60.6;13;39;29;10;34;77;102;1;
Sergio Gómez;23;3.9;9;4;6;1;2;5;8;62.5;3;5;3;2;2;11;9;1;
Andrei Girotto;31;35.0;122;73;71;45;6;74;132;56.1;58;55;24;31;73;195;176;1;
Eric García;22;15.7;24;16;16;5;3;9;20;45.0;11;23;10;13;19;43;36;1;
Jeremie Frimpong;23;30.1;53;27;22;26;5;23;44;52.3;21;24;3;21;16;69;40;0;
Przemysław Frankowski;28;31.5;77;51;37;31;9;39;80;48.8;41;38;6;32;41;118;42;2;
Fali;30;19.0;27;19;19;8;0;18;29;62.1;11;24;15;9;13;40;70;1;
Fábio;33;2.5;4;2;1;2;1;4;6;66.7;2;2;0;2;3;7;11;0;
Ismaël Doukouré;20;25.5;48;24;23;21;4;20;34;58.8;14;26;8;18;27;75;54;0;
Matt Doherty;31;7.4;16;10;12;3;1;8;10;80.0;2;11;6;5;8;24;14;1;
Junior Dina Ebimbe;23;11.8;30;19;16;14;0;16;33;48.5;17;18;5;13;11;41;20;0;
Baila Diallo;22;1.0;1;0;1;0;0;0;0;;0;1;1;0;0;1;1;0;
Abdou Diallo;27;5.3;6;5;5;1;0;1;3;33.3;2;8;5;3;8;14;22;0;
Fabio Depaoli;26;1.5;5;3;2;3;0;3;4;75.0;1;1;0;1;1;6;4;0;
Thomas Delaine;31;11.9;28;14;16;6;6;13;26;50.0;13;8;3;5;16;44;9;0;
Márton Dárdai;21;10.5;17;8;9;8;0;9;18;50.0;9;14;9;5;11;28;45;1;
Colin Dagba;25;10.6;32;20;17;10;5;19;26;73.1;7;18;2;16;17;49;19;0;
Yan Couto;21;12.9;25;18;11;11;3;12;20;60.0;8;7;2;5;5;30;10;0;
Carlos Clerc;31;29.3;75;51;55;16;4;31;50;62.0;19;29;7;22;28;103;94;1;
Patrick Ciurria;28;30.6;31;18;20;10;1;17;33;51.5;16;24;2;22;7;38;32;0;
Ben Chilwell;27;15.6;21;17;12;8;1;13;25;52.0;12;21;2;19;18;39;26;0;
Federico Chiesa;26;9.5;22;11;6;6;10;5;14;35.7;9;13;1;12;0;22;1;0;
Calum Chambers;28;3.9;9;6;7;2;0;6;8;75.0;2;5;4;1;7;16;10;1;
Yannick Carrasco;30;25.7;35;14;21;10;4;23;54;42.6;31;23;1;22;12;47;19;0;
Daniel Caligiuri;35;3.2;8;5;5;3;0;4;5;80.0;1;3;2;1;3;11;2;0;
Fernando Calero;28;17.9;46;29;27;15;4;21;34;61.8;13;31;13;18;13;59;52;0;
Jimmy Cabot;29;5.7;20;12;10;8;2;12;26;46.2;14;5;0;5;4;24;12;0;
Daley Blind;33;1.5;2;0;2;0;0;0;1;0.0;1;4;2;2;2;4;6;0;
Lautaro Blanco;24;9.7;16;9;10;4;2;9;26;34.6;17;8;1;7;2;18;10;1;
Juan Bernat;30;18.3;32;16;18;9;5;21;39;53.8;18;11;2;9;9;41;22;1;
Jérémie Bela;30;8.3;6;4;2;1;3;3;4;75.0;1;10;1;9;9;15;8;0;
Mads Bech Sørensen;24;0.2;0;0;0;0;0;0;0;;0;0;0;0;1;1;1;0;
Thierno Balde;21;23.9;27;14;19;4;4;18;30;60.0;12;15;3;12;23;50;39;0;
Mitchel Bakker;23;18.4;16;8;9;7;0;6;15;40.0;9;20;2;18;15;31;20;2;
Youcef Atal;27;8.7;38;22;18;15;5;23;32;71.9;9;9;0;9;14;52;13;0;
Santiago Arzamendia;25;5.4;9;8;7;1;1;6;21;28.6;15;11;1;10;2;11;15;1;
Stredair Appuah;19;0.7;2;1;0;2;0;0;0;;0;2;0;2;1;3;0;0;
Dennis Appiah;31;8.8;21;11;14;7;0;10;27;37.0;17;13;5;8;10;31;16;0;
Josep Antoni Gayá;23;1.1;0;0;0;0;0;0;0;;0;4;2;2;1;1;6;0;
Ethan Ampadu;23;29.3;66;37;33;28;5;17;41;41.5;24;48;23;25;36;102;98;0;
Ibrahim Amadou;30;4.7;10;7;6;3;1;7;11;63.6;4;7;3;4;10;20;20;0;
Faride Alidou;22;2.0;8;5;3;4;1;3;9;33.3;6;3;0;3;1;9;3;0;
Warren Zaire-Emery;17;10.3;17;10;5;10;2;8;29;27.6;21;11;0;11;12;29;17;0;
Noah Weißhaupt;22;4.7;11;6;3;7;1;2;7;28.6;5;4;0;4;6;17;8;0;
Valery;24;10.7;12;6;4;6;2;5;9;55.6;4;8;1;7;10;22;9;1;
Cengiz Ünder;26;27.7;37;19;15;13;9;13;34;38.2;21;18;2;16;18;55;13;0;
Umut Tohumcu;19;3.0;10;5;4;5;1;3;9;33.3;6;4;0;4;2;12;8;0;
Renato Tapia;28;16.1;47;25;21;21;5;18;37;48.6;19;29;11;18;19;66;37;0;
Mario Suárez;36;0.1;0;0;0;0;0;0;0;;0;1;0;1;0;0;0;0;
Tony Strata;19;1.5;4;3;4;0;0;4;5;80.0;1;2;0;2;1;5;7;0;
Antonio Sánchez;26;12.0;19;8;13;4;2;10;34;29.4;24;18;0;18;22;41;14;1;
Jérôme Roussillon;30;0.2;0;0;0;0;0;0;0;;0;0;0;0;0;0;0;0;
Pablo Rosario;26;19.6;46;26;22;20;4;18;34;52.9;16;15;5;10;23;69;32;1;
Nicolai Rapp;27;0.8;3;1;3;0;0;0;3;0.0;3;0;0;0;0;3;1;0;
Ivan Radovanović;35;7.5;12;4;8;4;0;4;10;40.0;6;9;3;6;7;19;9;1;
Ignacio Pussetto;28;1.7;6;3;2;3;1;3;4;75.0;1;4;0;4;0;6;3;0;
Portu;31;19.7;28;21;14;10;4;18;42;42.9;24;23;3;20;17;45;20;1;
Jean Onana;23;9.0;28;17;8;17;3;10;22;45.5;12;15;5;10;18;46;20;0;
Olasagasti;23;0.7;4;4;1;2;1;1;2;50.0;1;2;0;2;0;4;1;0;
Saúl Ñíguez;29;12.2;42;27;18;18;6;22;37;59.5;15;27;5;22;15;57;29;0;
Youssouf Ndayishimiye;25;6.3;13;9;8;5;0;6;11;54.5;5;8;5;3;12;25;22;1;
Michel Ndary Adopo;23;2.9;7;2;4;2;1;1;3;33.3;2;2;2;0;1;8;4;0;
Lucas Moura;31;1.7;8;5;1;3;4;1;4;25.0;3;0;0;0;2;10;1;1;
Tete Morente;27;23.0;33;21;18;13;2;15;36;41.7;21;23;3;20;25;58;28;0;
Marlos Moreno;27;0.1;2;2;2;0;0;2;3;66.7;1;1;1;0;0;2;0;0;
Jon Moncayola;25;27.2;55;39;24;22;9;30;76;39.5;46;37;5;32;17;72;32;2;
James Milner;37;10.1;26;16;11;11;4;15;34;44.1;19;14;2;12;12;38;15;0;
Batista Mendy;23;31.8;70;30;34;28;8;37;53;69.8;16;38;6;32;21;91;29;2;
Thiago Mendes;31;22.9;48;27;24;21;3;30;40;75.0;10;28;8;20;47;95;51;4;
Gary Medel;36;16.4;25;15;16;7;2;9;16;56.3;7;17;10;7;28;53;34;0;
Weston McKennie;25;11.7;14;5;3;9;2;5;8;62.5;3;15;4;11;11;25;15;1;
Omar Mascarell;30;27.2;53;26;32;19;2;31;64;48.4;33;51;19;32;45;98;54;1;
Lorenzo Malagrida;20;1.2;1;0;0;0;1;1;3;33.3;2;1;0;1;0;1;1;0;
Ruben Loftus-Cheek;27;17.1;25;14;8;14;3;12;21;57.1;9;15;2;13;12;37;23;0;
Marcos Llorente;28;18.9;32;15;16;10;6;17;30;56.7;13;26;2;24;17;49;19;0;
Mehdi Léris;25;27.3;63;46;30;24;9;23;55;41.8;32;38;6;32;27;90;34;0;
Mario Lemina;30;9.3;32;21;11;14;7;12;18;66.7;6;13;5;8;11;43;20;0;
Théo Le Bris;21;16.1;31;19;17;11;3;15;33;45.5;18;21;2;19;18;49;31;0;
Grigoris Kastanos;25;14.3;39;23;18;19;2;16;40;40.0;24;20;6;14;8;47;8;0;
Ayman Kari;19;1.1;0;0;0;0;0;0;0;;0;4;0;4;3;3;0;0;
Vitaly Janelt;25;24.5;54;27;20;24;10;21;49;42.9;28;29;9;20;29;83;26;0;
Pape Gueye;24;5.5;18;7;10;7;1;7;15;46.7;8;9;2;7;9;27;2;0;
Pascal Groß;32;36.0;59;38;23;27;9;25;55;45.5;30;32;10;22;13;72;21;1;
José Gragera;23;5.1;19;9;11;6;2;6;11;54.5;5;10;4;6;7;26;18;0;
James Garner;22;8.9;16;13;4;8;4;9;19;47.4;10;9;1;8;12;28;13;0;
Fernando;36;17.5;34;23;14;17;3;18;30;60.0;12;21;10;11;24;58;29;0;
Nicolás Ezequiel Fernández;23;5.7;23;12;10;7;6;9;17;52.9;8;7;0;7;5;28;2;1;
Mikael Ellertsson;21;1.9;4;2;1;3;0;0;3;0.0;3;2;1;1;2;6;0;0;
Pablo Durán;22;0.4;0;0;0;0;0;0;0;;0;2;1;1;1;1;2;0;
Jodel Dossou;31;2.9;7;4;3;2;2;4;4;100.0;0;2;1;1;1;8;0;0;
John Donald;23;12.1;20;11;9;9;2;7;14;50.0;7;14;7;7;14;34;23;1;
Mamady Diarra;23;0.7;2;1;2;0;0;1;2;50.0;1;2;0;2;0;2;0;0;
Bryan Cristante;28;32.6;113;62;55;49;9;55;90;61.1;35;39;10;29;18;131;53;0;
Pathé Ciss;29;14.2;39;29;11;23;5;15;34;44.1;19;23;10;13;22;61;34;0;
Yanis Cimignani;21;3.1;11;5;3;7;1;4;5;80.0;1;5;1;4;2;13;2;0;
Franco Cervi;29;21.0;76;46;29;36;11;33;66;50.0;33;33;1;32;36;112;16;0;
Carmona;21;6.5;16;9;7;6;3;6;16;37.5;10;14;2;12;8;24;9;0;
Valentin Carboni;18;0.3;1;1;0;1;0;1;3;33.3;2;1;0;1;0;1;0;0;
Pierrick Capelle;36;15.9;36;21;17;15;4;22;55;40.0;33;24;3;21;15;51;24;0;
Antonio Candreva;36;30.3;17;7;13;2;2;11;38;28.9;27;7;3;4;17;34;32;0;
Eduardo Camavinga;21;22.3;68;48;32;21;15;24;64;37.5;40;24;5;19;17;85;25;0;
Joe Bryan;30;2.0;5;4;3;2;0;4;4;100.0;0;2;0;2;1;6;1;0;
Leonardo Bittencourt;30;18.1;53;28;20;25;8;25;62;40.3;37;13;0;13;10;63;15;0;
Alexis Beka Beka;22;6.1;16;5;6;9;1;4;15;26.7;11;9;1;8;12;28;6;0;
Simone Bastoni;27;13.2;47;24;23;19;5;15;33;45.5;18;20;5;15;8;55;14;0;
Iddrisu Baba;27;18.9;31;17;15;16;0;15;32;46.9;17;18;8;10;11;42;39;0;
José Antonio;19;0.5;2;1;0;0;2;0;0;;0;0;0;0;0;2;0;0;
Paul Akouokou;26;5.0;16;9;13;3;0;13;20;65.0;7;2;2;0;12;28;17;1;
Paxten Aaronson;20;1.9;6;5;2;2;2;2;3;66.7;1;2;1;1;0;6;2;0;
Mitchell Weiser;29;28.0;71;43;38;24;9;38;75;50.7;37;50;7;43;28;99;38;1;
Timothy Weah;23;19.4;24;14;13;9;2;16;29;55.2;13;17;3;14;23;47;18;0;
Sada Thioub;28;11.8;19;10;9;8;2;8;17;47.1;9;13;0;13;7;26;5;1;
Arnaud Souquet;31;4.0;22;16;13;7;2;11;14;78.6;3;8;3;5;4;26;4;0;
Aitor Ruibal;27;16.2;47;29;35;9;3;31;58;53.4;27;17;2;15;24;71;41;0;
Pascu;20;0.1;0;0;0;0;0;0;0;;0;0;0;0;0;0;0;0;
Jordi Osei-Tutu;25;8.3;23;18;13;5;5;12;23;52.2;11;12;5;7;10;33;8;0;
Hugo Novoa;20;2.0;8;2;1;3;4;4;7;57.1;3;4;0;4;1;9;0;0;
Jesús Navas;38;22.0;19;12;8;3;8;11;22;50.0;11;18;7;11;22;41;52;1;
João Moutinho;25;0.6;7;1;5;1;1;3;4;75.0;1;1;1;0;0;7;0;0;
Farid El Melali;26;9.0;21;12;7;12;2;11;22;50.0;11;16;0;16;8;29;7;0;
Kevin Mbabu;28;1.6;3;2;2;1;0;1;3;33.3;2;2;0;2;3;6;3;0;
Valentino Livramento;21;0.3;2;1;2;0;0;0;0;;0;0;0;0;2;4;3;0;
Jamal Lewis;25;0.1;0;0;0;0;0;0;0;;0;0;0;0;0;0;0;0;
Giorgos Kyriakopoulos;27;7.8;13;6;4;5;4;10;23;43.5;13;14;2;12;4;17;10;0;
Filip Kostić;31;28.5;41;26;17;20;4;21;47;44.7;26;30;4;26;16;57;32;0;
Anthony Jung;32;29.1;46;27;19;20;7;31;58;53.4;27;30;6;24;22;68;63;0;
Ismail Jakobs;24;12.4;11;5;7;3;1;5;12;41.7;7;9;1;8;9;20;18;0;
Samuel Iling-Junior;20;3.5;7;2;3;1;3;4;9;44.4;5;5;1;4;2;9;6;0;
Jannes Horn;26;0.7;2;1;1;1;0;1;1;100.0;0;1;0;1;3;5;2;0;
Henrique;29;4.0;9;4;3;2;4;6;13;46.2;7;3;1;2;5;14;8;0;
Gabriel Gudmundsson;24;9.3;19;11;7;10;2;12;22;54.5;10;11;2;9;10;29;20;0;
Raphael Framberger;28;2.0;10;6;6;4;0;3;5;60.0;2;2;1;1;2;12;5;0;
Kilian Fischer;23;5.6;9;6;3;4;2;6;11;54.5;5;6;0;6;5;14;18;0;
Shane Duffy;31;0.2;0;0;0;0;0;0;0;;0;0;0;0;0;0;0;1;
Souleyman Doumbia;27;19.9;45;31;31;13;1;17;31;54.8;14;20;3;17;27;72;27;1;
Moussa Djenepo;25;7.9;19;11;13;5;1;11;26;42.3;15;19;2;17;11;30;7;0;
Edan Diop;19;2.5;13;8;3;3;7;7;15;46.7;8;7;1;6;4;17;1;0;
Marco D'Alessandro;32;3.2;4;4;3;1;0;2;5;40.0;3;2;0;2;1;5;3;0;
Juan Cuadrado;35;23.1;50;34;34;13;3;27;65;41.5;38;15;2;13;24;74;32;0;
David Čolina;23;1.8;4;1;1;1;2;2;2;100.0;0;8;0;8;4;8;3;0;
Franco Carboni;20;0.7;1;1;1;0;0;0;2;0.0;2;3;0;3;1;2;0;0;
João Cancelo;29;11.2;23;14;9;10;4;10;23;43.5;13;14;2;12;15;38;22;0;
Lee Buchanan;22;5.2;14;10;2;11;1;6;12;50.0;6;5;0;5;12;26;21;0;
Andreas Bruus;24;18.1;12;6;9;3;0;8;20;40.0;12;13;2;11;17;29;24;0;
Ismaëlben Boura;23;1.0;6;4;4;2;0;5;6;83.3;1;2;1;1;2;8;3;0;
Ridle Baku;25;28.7;50;26;29;17;4;32;58;55.2;26;44;6;38;21;71;59;0;
Mehmet Aydin;21;6.3;25;18;14;9;2;11;24;45.8;13;11;0;11;10;35;15;0;
Ayoub Amraoui;19;3.3;6;5;3;3;0;2;5;40.0;3;1;0;1;4;10;4;0;
Jim Allevinah;28;24.9;39;24;24;11;4;19;62;30.6;43;24;2;22;24;63;26;1;
Felix Agu;24;0.5;1;0;0;1;0;0;0;;0;1;1;0;0;1;0;0;